Gs^Fp, Gs^Fp, Gg, Gs^Fp, Gs^Fp, Hh, Gg, Hh, Hh, Gs^Fp, Hh, Hh, Hh, Gg, Gg, Ss, Ss, Ss, Ss, Ss, Gg, Gg, Gg, Gg, Re^Gvs, Gg, Gg, Gg, Gg, Gs^Fds, Gs^Fds, Gs^Fds, Gs^Fds, Gs^Fds, Gg, Gs^Fds, Gg, Hh, Hh^Fms, Hh, Hh, Hh
Gs^Fp, Gs^Fp, Gg, Gg^Fp, Gg^Fp, Hh, Gg, Hh, Hh, Gs^Fp, Hh, Hh, Hh, Gg, Hh, Gg, Gg, Ss, Gg, Ss, Re^Gvs, Gg, Re^Gvs, Re^Gvs, Re^Gvs, Re, Re^Gvs, Gg, Ce, Gs^Fds, Ce, Gs^Fds, Gg, Gg, Gg, Gg, Gg, Hh, Hh^Fds, Hh, Hh, Hh
Hh, Hh, Ss, Ww, Ww, Ss, Ss, Gs^Fp, Gs^Fp, Gs^Fp, Gs^Fp, Gs^Fp, Gg, Hh, Gg, Gg, Gg^Fms, Gg, Gg, Re^Gvs, Ce, Re^Gvs, Ce, Re^Gvs, Re^Gvs, Re^Gvs, Rr, Gs, Gs, Ce, Rr, Ce, Ce, Ce, Ce, Ce, Ce, Gg, Gg, Hh^Fms, Hh, Hh
Ss, Ss, Ss, Ss, Ww, Ww, Ww, Gg, Ww, Ss, Gg, Gg^Fp, Gg^Fp, Hh, Gg, Gg, Ww, Gs^Fds, Ce, Ce, Re^Gvs, Ce, Re^Vl, Rr, Re, Re^Vh, Rr, Gs, Gs^Fds, Gs, Gs^Fds, Rr, Rr, Re^Vl, Rr, Gs^Fds, Rr, Ce, Ce, Gg, Gg, Gg
Ww, Ww, Ww, Ww, Ww, Ww, Ww, Ww, Ww, Ww, Ww, Ww, Ww, Gg^Fp, Ww, Ww, Gg, Gg, Ce, Re^Gvs, Re^Gvs, Re^Gvs, Gs, Rr, Gs, Gs, Rr, Rr, Rr, Re^Vh, Rr, Rr, Gs, Rr, Gs, Rr, Re^Vh, Gs^Fds, Re^Gvs, Re^Gvs, Gg, Gg
Ww, Ww, Ss, Ww, Ww, Ss, Ss, Ww, Ww, Ww, Ww^Bw\, Ww, Ss, Ww, Gg, Gg, Gs^Fms, Gs^Fds, Ce, Re^Gvs, Gs, Gs, Rr, Rr, Gs, Gs, Rr, Gs, Gs, Rr, Gs, Gs, Rr, Rr, Gd, Re, Rr, Re^Gvs, Re^Gvs, Re^Gvs, Gs^Fds, Gs^Fds
Ww, Ww, Ww, Ss, Gg, Ss, Ss, Ss, Ww, Ww, Gs^Fp, Gg, Ww^Bw\, Ss, Gg, Re^Vh, Gg, Gg, Rr, Ce, Rr, Gs, Rr, Gs, Re, Re^Vl, Rr, Gs, Gs, Gd, Gs, Rr, Gs, Gs, Chr, Gs, Rr, Gs, Gs^Fds, Ce, Ce, Gs^Fds
Ss, Ss, Gg, Gg, Gg, Gg, Gs, Gg, Ww, Ss, Gs^Fp, Gs^Fp, Gs^Fp, Gg, Gg, Ww, Re, Re, Rr, Rr, Rr, Rr, Rr, Rr, Rr, Rr, Gg^Fet, Rr, Rr, Gs, Rr, Rr, Gs, Ch, 1 Kh, 2 Rr, Re, Re^Vl, Re, Gg, Gg^Fds, Gg^Fds
Gg, Gg, Gg, Gg, Gs^Fp, Gg, Re^Vh, Ce, Ss, Ww, Ss, Ss, Ce, Gg, Re, Re, Gg, Re, Gs^Fds, Ce, Gd, Gs, Rr, Gs, Gs, Rr, Rr, Rr, Re, Rr, Gs, Rr, Rr, Rr, Chr, Chr, Gs, Gs, Gg, Ce, Gg, Gs^Fds
Gg, Gg, Gs, Gs^Fp, Gg, Gs, Gs, Ce, Re, Ww, Ww^Bw/, Re, Re, Re, Gg, Gg, Gg, Gg, Gs^Fds, Ce, Gs, Gs, Rr, Gs, Gs^Fds, Gs, Rr, Gs, Gs, Gs, Gs, Gs, Rr, Gs, Gs, Gd, Gs, Gs, Gg, Ce, Gg, Gg^Fds
Gg, Gg, Gs^Fp, Gg, Gs^Fp, Gs, Re, Re, Ce, Re, Ww, Ww, Ce, Gg, Gs^Fp, Gs^Fms, Gs^Fms, Gs^Fds, Gs^Fds, Gs, Gs^Fds, Gs, Re^Gvs, Rr, Rr, Gd, Rr, Re^Vl, Re, Gs^Fds, Gs, Rr, Gs, Rr, Re^Vh, Gs, Gs^Fds, Gg, Ce, Ce, Gg, Gg
Gs^Fp, Gs^Fp, Gg, Gg, Gs^Fp, Re, Gs^Fms, Gs, Gs, Ce, Gg^Vh, Ww, Ww, Gg^Fp, Gg^Fp, Gg, Gg, Gg, Ce, Gg, Gs, Re^Gvs, Re^Gvs, Re^Vh, Rr, Gs, Gs, Rr, Rr, Rr, Rr, Rr, Re^Vl, Re, Re^Gvs, Gs, Re^Gvs, Gs, Gs, Gg, Gg, Gg
Gs^Fp, Gs^Fp, Gg, Gs^Fp, 3 Re, Re, Gs, Gs^Fms, Gs^Fds, Gs^Fds, Gg, Gg^Fms, Gg, Ww, Gg, Re^Vl, Gs^Fp, Gg, Ce, Gg, Gs, Re^Gvs, Re^Gvs, Gs, Ce, Re^Vl, Gs, Rr, Re^Vh, Gs^Fds, Gs, Rr, Re^Gvs, Re^Gvs, Re^Gvs, Re^Gvs, Ce, Gs, Re^Gvs, Re^Gvs, Gs^Fms, Gs^Fms
Gg, Gg, Gg, Gg, Re, Gg, Gg, Gs^Fds, Gs^Fds, Gg, Gg, Gs^Fds, Gg, Ww, Ww, Gg^Fp, Gg, Gg, Gs^Fp, Ce, Ce, Re^Gvs, Gs, Gs, Ce, Re, Gs, Rr, Gs, Gs, Gs, Rr, Re^Gvs, Re^Gvs, Re^Gvs, Re^Vh, Ce, Re^Gvs, Re^Gvs, Gs^Fms, Hh, Hh
Gs^Fp, Gs^Fp, Gs^Fp, Gg, Re, Gg, Gs^Fms, Gs^Fds, Gs^Fms, Gg, Gs^Fds, Gg, Gs^Fds, Gg, Gg^Fms, Ww, Ww, Gg, Gg^Fp, Gg^Fp, Gg^Fp, Gg, Ss, Gg, Gg, Ce, Ce, Gs, Ce, Gs, Ce, Rr, Gs, Re^Gvs, Ce, Ce, Gs, Re^Gvs, Hh^Fms, Hh^Fms, Ww, Ww
Gg, Gg, Gg, Gg, Re, Gg, Gg, Gg, Gg, Gg, Gg, Gg, Gg, Gs^Fms, Gg, Gg, Gg^Fp, Ww, Ww, Ww, Ww, Ww, Ww, Ss, Gs^Fms, Gg, Gs^Fds, Ce, Gg, Ce, Gg, Gs, Gs^Fms, Gs, Gg, Gg, Gs^Fms, Hh^Fms, Hh, Hh, Ww, Ww
Gg, Gg, Gg, Gg, Re, Gg, Gg, Gg, Gg, Gg, Gg, Gg, Gg, Gs^Fds, Gg, Gg, Gs^Fp, Gg^Fp, Ww, Ww, Ww, Ww, Ww, Ss, Gs^Fp, Gg, Gs^Fms, Gg, Gs^Fms, Gs^Fms, Gs^Fms, Gs^Fds, Gs^Fms, Gg, Gg, Gg, Gs^Fms, Gs^Fms, Hh, Hh, Ww, Ww
