Ss, Ss, Ss, Ss, Ss, Ss, Gll^Fp, Gll^Fp, Gs, Gg, Gg, Gg, Gll^Fp, Gs, Gll^Fp, Gll^Fp, Gg, Gg, Gg, Gg, Gll^Fp, Gll^Fp, Gll^Fp, Gg, Gg, Gg, Gg, Hh, Gs^Fp, Hh, Hh^Fp, Hh^Fp, Hh^Fms, Hh^Fms, Hh, Gs, Hh, Hh^Fds, Gs^Fds, Gs^Fds, Gs^Fds, Gs^Fds, Gs^Fds, Gs^Fds
Ss, 5 Ss, Ss, Ss, Ss, Ss, Gll^Fp, Gll^Fp, Gs, Gg, Gg, Gg, Gll^Fp, Gg, Gll^Fp, Gll^Fp, Gg, Gg, Gg, Gg, Gll^Fp, Gll^Fp, Gll^Fp, Gg, Gg, Gg, Gs, Hh, Gs^Fp, Hh, Hh^Fp, Gs^Fms, Hh^Fms, Hh^Fms, Hh^Fms, Gs, Hh, Hh^Fds, Gs^Fds, Gs^Fds, Gs^Fds, Gs^Fds, Gs^Fds, Gs^Fds
Ss, Ss, Ss, Gll^Fp, Gll^Fp, Gll^Fp, Gll^Fp, Gll^Fp, Gs^Vl, Gs, Gg, Gg, Gg, Gg, Gg, Gg, Gg, Gg, Gg, Gg, Gll^Fp, Gll^Fp, Gll^Fp, Gg, Gg, Gg, Gs, Gs^Fms, Hh, Hh, Hh, Gs^Fms, Gs^Fms, Hh^Fms, Hh, Hh, Hh^Fds, Gs^Fds, Gs^Fds, Gs^Fds, Gs^Vh, Gs^Fds, Gs^Fds, Gs^Fds
Ss, Gll^Fp, Gll^Fp, Gll^Fp, Re^Fp, Re^Fp, Gll^Fp, Gll^Fp, Gll^Fp, Gs, Gg, Gs, Gg, Gg, Gg, Gs, Gg, Gg, Gs, Gs, Gs, Gll^Fp, Gll^Fp, Gll^Fp, Gg, Gg, Gs, Gll^Fp, Gs^Fms, Gs^Fms, Gs^Fms, Gg, Gs^Fds, Gg, Gg, Gg, Hh^Fds, Gs^Fds, Gs^Fds, Gs^Fds, Gs^Fds, Gs^Fds, Gs^Fds, Gs^Fds
Ss, Gll^Fp, Re^Fp, Ce, Ss, Ce, Re^Fp, Re^Fp, Gll^Fp, Gll^Fp, Gs, Gll^Fp, Gs, Gs, Gg, Gg, Gg, Gg, Gg, Gs, Gll^Fp, Gll^Fp, Gll^Fp, Gll^Fp, Gll^Fp, Gll^Fp, Gs^Fms, Gll^Fp, Gs^Fms, Gs^Fds, Gg, Gg, Gg, Gg, Gg, Gg, Gs^Fds, Gs^Fds, Gs^Fds, Gs^Fds, Gs^Fds, Gs^Fds, Gs^Fds, Gs^Fds
Ss, Gll^Fp, Gll^Fp, Ss, Ke, Ce, Re^Fp, Gll^Fp, Gll^Fp, Wo, Gll^Fp, Ss^Vhs, Gll^Fp, Gll^Fp, Gs, Gg, Gg, Gs, Gg, Gs, Gll^Fp, Gll^Fp, Gll^Fp, Gll^Fp, Gs^Vh, Gll^Fp, Gll^Fp, Gs^Fms, Gs^Fms, Gs^Fms, Gs^Fms, Gs^Fds, Gg, Gs^Fds, Gs^Fds, Gs^Vl, Gs^Fds, Gs^Fds, Gs^Fds, Gs^Fds, Gs^Fds, Gs^Fds, Gs^Fds, Gs^Fds
Gll^Fp, Gll^Fp, Gll^Fp, Ss, Ce, Ss, Re^Fp, Gll^Fp, Wo, Ss, Ss, Ss, Ss, Ss, Ds, Gs, Gg, Gg, Gg, Gs, Gll^Fp, Gll^Fp, Gll^Fp, Gll^Fp, Gll^Fp, Gll^Fp, Gll^Fp, Gll^Fp, Wo, Wo, Gs^Fms, Gs^Fds, Gg, Gs^Fds, Gs^Fds, Gs^Fds, Gs^Fds, Gs^Fds, Ww, Gs^Fds, Gs^Fds, Gs^Fds, Gs^Fds, Gs^Fds
Gll^Fp, Gll^Fp, Gll^Fp, Gll^Fp, Gll^Fp, Gll^Fp, Gll^Fp, Gll^Fp, Wo, Ss, Ww, Ww, Ww, Ss, Ds, Gs, Gg, Gg, Gg, Gs, Gd, Gs, Gs, Gll^Fp, Gll^Fp, Gll^Fp, Gll^Fp, Gg, Wo, Gg, Gs^Fds, Gg, Gg, Gs^Fds, Gs^Fds, Gs^Fds, Gg, Ww, Ww, Gs^Fds, Gs^Fds, Gg, Gg, Gg
Gll^Fp, Gll^Fp, Gll^Fp, Gs, Gll^Fp, Gll^Fp, Gll^Fp, Ww, Wo, Ss, Ss, Ss^Vhs, Ss, Ss, Gll^Fp, Gs, Gg, Gg, Gs, Hh, Gs^Fp, Hh, Gll^Fp, Hh, Gll^Fp, Gg, Gg, Gg, Gg, Gg, Gg, Gg, Gg, Gs^Fds, Gs^Fds, Gs^Fds, Gs^Fds, Gs^Fds, Ww, Ww, Gg, Gs^Fds, Gg, Gg
Gll^Fp, Gll^Fp, Gll^Fp, Gll^Fp, Gll^Fp, Ww, Ww, Ww, Wo, Ww, Ss, Ss, Ss, Gll^Fp, Gll^Fp, Gll^Fp, Gs, Gll^Fp, Gs, Hh, Hh, Gll^Fp, Hh, Hh, Gll^Fp, Gg, Gg, Gg, Gg, Gs^Fms, Gs^Fds, Gs^Fms, Gg, Gg, Gs^Fds, Gll, Gs^Fds, Gs^Fds, Ww, Ww, Gs^Fds, Gs^Vh, Gs^Fms, Gs^Fds
Gs, Gs, Gll^Fp, Gll^Fp, Gll^Fp, Gll^Fp, Ss, Wo, Ww, Ss, Ww, Wo, Wo, Gll^Fp, Gll^Fp, Gs^Vh, Gll^Fp, Gg, Gll^Fp, Gll^Fp, Gll^Fp, Hh, Gll^Fp, Gll^Fp, Gll^Fp, Gll^Fp, Gg, Gg, Gs^Fds, Gs^Fms, Gs^Fms, Gs^Fds, Gs^Fds, Gs^Fms, Gg, Gs^Fds, Ww, Gs^Fds, Ww, Gg, Gs^Fms, Gs^Fds, Gs^Fms, Gs^Fms
Gs, Gs, Gs, Gs, Gll^Fp, Gll^Fp, Ss, Ss^Vhs, Wo, Wo, Ww, Ss, Wo, Gll^Fp, Gll^Fp, Gll^Fp, Gll^Fp, Gg, Gg, Gg, Gg, Gg, Hh, Gll^Fp, Gll^Fp, Gll^Fp, Gll^Fp, Gs^Fms, Gll^Vl, Gs^Fms, Gs^Fms, Gs^Fms, Gs^Fms, Gs^Fds, Gg, Ww, Gs^Fds, Ww, Gg, Gs, Gs^Fds, Gs^Fms, Gs^Fms, Gs^Fds
Gll^Fp, Gll^Fp, Gll^Fp, Gll^Fp, Gs, Gs, Gll^Fp, Gll^Fp, Wo, Gll^Fp, Ss, Gll^Fp, Gll^Fp, Gll^Fp, Gll^Fp, Ww, Gg, Gll^Fp, Gg, Gg, Gg, Gg, Gg, Gll^Fp, Gs^Vl, Gll^Fp, Gll^Fp, Gll^Fp, Gs^Fms, Gg, Gg, Gg, Gs^Fms, Gg, Ww, Ww, Ww, Gg, Gg, Gs^Fms, Gs^Fms, Gs^Fp, Gg, Gg
Gs^Fp, Gll^Fp, Gll^Fp, Gll^Fp, Gs, Gs, Gs, Gs, Gll^Fp, Gs, Gll^Fp, Gll^Fp, Gll^Fp, Ss, Ww, Ww, Gll^Fp, Gll^Fp, Gll^Fp, Gll^Fp, Gg, Gg, Gg, Gg, Gll^Fp, Gg, Gll^Fp, Gll^Fp, Gs^Fms, Gg, Gg, Gg, Gg, Gg, Ww, Ww, Ww, Gs^Fp, Gs^Fp, Gs^Fp, Gs^Fp, Gs^Fp, Gg, Gg
Ss^Vhs, Gll^Fp, Gll^Fp, Gll^Fp, Gll^Fp, Gll^Fp, Gs, Gs, Gs, Gs, Gs, Gll^Fp, Ss, Gll^Fp, Ww, Ww, Ss, Gll^Fp, Gs^Vl, Gll^Fp, Gg, Gg, Gg, Gs^Fp, Gg, Gg, Gg, Gg, Gg, Gg, Gg, Gg, Gg, Gs^Fp, Gg, Ww, Ww, Gs^Fp, Gs^Fp, Gs^Fp, Gs^Fp, Gs^Fp, Gg, Gg
Ss, Gll^Fp, Gll^Fp, Gll^Fp, Gll^Fp, Gll^Fp, Gs, Gs, Gs^Ve, Gs, Gs, Gll^Fp, Gll^Fp, Gs, Gll^Fp, Gll^Fp, Ss, Gll^Fp, Gll^Fp, Gll^Fp, Gll^Fp, Gll^Fp, Gs^Fms, Gs^Fms, Gs^Fms, Gs^Fds, Gs^Fms, Gs^Fms, Gg, Gg^Efm, Gg^Efm, Gd^Fp, Gd^Fp, Gll^Vl, Gd^Fp, Gd^Fp, Ww, Gg, Gs^Fp, Gs^Fp, Gs^Vl, Gs^Fp, Gg, Gg
Ss, Gs^Fp, Gs^Vl, Gs, Gs, Gs, Gs, Gs, Gs, Gll^Fp, Gll^Fp, Gs, Gs, Gg, Gll^Fp, Gll^Fp, Gll^Fp, Gg, Gs, Gs^Fms, Gg, Gg^Efm, Gg, Gg, Gg, Gg^Efm, Gs^Fds, Gg, Gs^Fms, 1 Gg, 2 Gg, Gd^Fp, Gd^Fp, Gd^Fp, Gd^Fp, Gd^Fp, Ww, Gg, Gg, Gg, Gd^Fp, Gg, Gg, Gg
Ww, Ww, Gs^Fp, Gll^Fp, Gs, Gs, Gs, Gs, Gs, Gll^Fp, Gll^Fp, Gll^Fp, Gll^Fp, Gll^Fp, Gg, Gg, Gg, Gs^Fp, Gs^Fp, Gg^Efm, Gg^Efm, Gs^Fds, Gs^Fds, Gg, Gg, Re, Gg, Gs^Fds, Gs^Fds, Gs^Fms, Gs^Fms, Gd^Fp, Gs^Vh, Gd^Fp, Gd^Fp, Gd^Fp, Ds, Ww, Ww, Gd^Fp, Gg, Gd^Fp, Gd^Fp, Gd^Fp
Wo, Wo, Ss, Ss, Gll^Fp, Gll^Fp, Gll^Fp, Gll^Fp, Gll^Fp, Gs^Fp, Gs^Fp, Gs^Fp, Gll^Fp, Gll^Fp, Gll^Fp, Gg, Gs^Fp, Gg, Gs^Fms, Gg, Gs^Fds, Gs^Fds, Ce, Re, Re, Gs, Ce, Gg, Gs^Fms, Gg, Gd^Fp, Gg, Gd^Fp, Gd^Fp, Gd^Fp, Gd^Fp, Ds, Ww, Ww, Gd^Fp, Gd^Fp, Gd^Fp, Gd^Fp, Gd^Fp
Wo, Wo, Ww, Ss, Gll^Fp, Gll^Fp, Gll^Fp, Gll^Fp, Gs^Fp, Wo, Wo, Gs^Fp, Gll^Fp, Gll^Fp, Gll^Fp, Gg, Gs^Fp, Gg, Gg^Efm, Gs^Fds, Gg, Ce, Gs, 3 Ke, Re, Ke, Gs, Ce, Hh, Hh, Gg, Gd^Fp, Gd, Gd^Fp, Ss, Gd^Fp, Ss, Ds, Ww, Gd^Fp, Gd^Em, Gd^Fp, Ss, Gd^Fp
Ww, Wo, Ww, Ss, Gll^Fp, Gll^Vl, Gll^Fp, Gll^Fp, Gs^Fp, Gs^Fp, Gs^Fp, Gll^Fp, Gll^Fp, Gll^Fp, Gll^Fp, Gg, Gs^Fp, Gs^Fms, Gg^Efm, Gg, Gg, Ce, Ce, Gs, Re^Vct, Gs, Gs, Ce, Hh, Ss, Ss, Gd^Fp, Gd^Fp, Gd, Gd^Fp, Gd^Fp, Wwf, Ww, Ss, Gd^Fp, Gd^Fp, Gd^Fp, Ss, Ss
Ww, Wo, Ww, Gs^Fp, Gll^Fp, Gll^Fp, Gll^Fp, Gll^Fp, Gll^Fp, Gll^Fp, Gll^Fp, Gll^Fp, Gll^Fp, Gll^Fp, Gg, Gg, Gg, Gs, Gs^Fms, Gs^Fds, Gg^Efm, Gs^Fds, Ce, Rb, Rb, Re, Ce, Ce, Gs^Fms, Gs^Fms, Ss, Gd^Fp, Gd^Fp, Gd^Fp, Gd^Fp, Gd, Wwf, Ss, Ss, Gd^Emf, Ss^Vhs, Ss, Ss, Ss
Wo, Gg, Gg, Gll^Fp, Gll^Fp, Gll^Fp, Gll^Fp, Gll^Fp, Gll^Fp, Ss, Gll^Fp, Gll^Fp, Ww, Ww, Ww, Wo, Gs, Re, Ww, Gs^Fms, Gs^Fds, Gg, Gg, Re, Re, Gs, Gd, Gd, Gd, Gs^Fms, Gd^Fp, Ss, Ss^Vhs, Ss, Ww, Gd^Fp, Ww, Ww, Ww, Ss, Ss, Ss, Ss, Gd^Fp
Wo, Gg^Fp, Gs, Gs, Gll^Fp, Gll^Fp, Gll^Fp, Gll^Fp, Ss^Vhs, Ww, Ss, Ww, Gll^Fp, Gll^Fp, Gg, Ww, Ww, Ww, Gg, Ww, Wwf, Gg, Gg, Gs^Fms, Gs^Fms, Gs^Fms, Gd, Gs^Fms, Gs^Fms, Gd^Fp, Ds, Ss, Ss, Ss, Ww, Ww, Ww, Ss, Ss, Ss, Ss, Ss, Ss, Gd^Fp
Wo, Hh, Ww, Hh, Gs, Gll^Fp, Gll^Fp, Wo, Ww, Ww, Ww, Ww, Gll^Fp, Ss, Re, Ds, Gg, Gg, Wo, Gg, Gg, Ww, Ww, Gs^Fms, Ww, Gs^Fms, Gd^Fp, Gd^Fp, Ss^Vhs, Ds, Ss, Ss, Ss, Ss, Gd^Fp, Ss, Ss, Gd^Fp, Gd^Fp, Gd^Fp, Gd^Fp, Ss, Gd^Fmw, Gd^Fp
Ww, Ww, Hh, Ww, Ww, Ww, Ww, Ww, Ww, Gg^Fp, Ss^Vhs, Ss, Ds, Ss, Ss, Ss, Ss, Gg, Gg, Gg, Ww, Ww, Ss, Ww, Gs^Fms, Gs^Fms, Gd^Fp, Ss, Ss, Ss, Ss, Ss, Ww, Gd^Fp, Gd^Vc, Gd^Fp, Gd^Fp, Gd^Fmw, Gd, Gd^Fp, Gd^Fmw, Gd^Fmw, Gd^Fmw, Gd^Fp
Ww, Ww, Wo, Hh, Ww, Hh, Ww, Ww, Gg^Fp, Gs^Fp, Gg^Fp, Gs^Fp, Ss, Ss, Ss, Ss, Ds, Re, Re, Gs^Fms, Gs^Fms, Ss, Ss^Em, Ss, Gd^Em, Gd, Ss^Em, Gs^Fms, Gs^Fms, Gs^Fms, Ww, Ww, Ds, Ds, Gd^Em, Gd^Fp, Gd^Fp, Gd^Fmw, Gd^Fmw, Gd^Fp, Gd^Fp, Gd^Fp, Gd^Fp, Gd^Fmw
Gg^Fp, Gs^Fp, Hh, Hh, Hh, Hh, Ss, Ss, Gg^Fp, Gg^Fp, Ss, Ss, Ss, Gs^Fms, Ss, Re, Re, Gs^Vl, Gs^Fms, Gs^Fms, Gd^Fp, Gs^Fms, Ss, Ss, Gs^Fms, Gd^Fp, Ss, Gs^Fms, Wwf, Wwf, Ww, Ww, Ds, Gd^Em, Gd^Fmw, Gd^Fmw, Gd, Gd^Fp, Gd^Fp, Gd^Fp, Re^Fp, Ss^Vhs, Ss, Gd^Fp
Gd^Fp, Gs, Hh, Hh, Hh, Hh, Ss, Gd^Fp, Re, Re, Ss, Gs^Fms, Ss, Re, Re, Gd^Fp, Gs^Fms, Gd^Fp, Gd^Fmw, Gd^Fp, Gs^Fms, Gs, Gd^Fp, Gs^Fms, Gd^Fp, Gd^Fp, Ss^Vhs, Ss, Ss, Ss^Em, Gd^Fp, Ww, Ss, Ss, Gd^Fp, Gd^Fp, Gd, Gd, Gd^Fp, Ce, Ce, Gll^Fp, Ss, Ss
Gd^Fp, Re, Gd^Fp, Gd^Fp, Gd^Fp, Re, Hh, Gd^Fp, Re, Gs^Fms, Re^Vhs, Re, Re, Gs^Fms, Gs^Fms, Gd^Fp, Gd, Gd^Fp, Gd^Fmw, Gs^Fms, Ss^Vhs, Gd^Fp, Ss, Gd^Fp, Gs^Fms, Gs^Fms, Gd, Ss, Gd^Fp, Ss, Gd^Fmw, Gd^Fp, Wwf, Gd^Fp, Gd^Fmw, Gd^Em, Gd, Re^Edb, Ce, Ke, Ce, Ss, Ss, Ss
Re, Gd^Fp, Re, Gs^Vh, Re, Gd^Fp, Re, Gd^Fp, Gd^Fp, Gs^Fms, Gs^Fms, Gs^Fms, Gd, Gd^Fp, Gd^Fp, Gd, Gs^Fms, Gd^Fp, Ss, Ss^Em, Ss^Em, Ss^Em, Ss, Ss, Ss, Ss, Gd^Fp, Gd^Em, Gd^Fmw, Gd^Fp, Ww, Gd^Fp, Wwf, Ss, Gd^Fp, Gd^Fmw, Gd^Fp, Re, Ce, Ce, Rb^Edb, Ss, Ss, Ss
Gs, Gd^Fp, Gs, Gd^Fp, Gs, Gd^Fp, Gd^Fp, Gs^Fms, Gd^Fp, Gs^Fms, Gd^Fp, Gd, Gd, Gd, Gd, Gs^Fms, Gd^Fp, Ss^Em, Ss, Gd^Emf, Ss^Em, Gd^Fp, Gd^Fmw, Ss^Em, Ss, Gd^Fmw, Gd^Fp, Gd^Fp, Ss^Em, Ww, Ss, Ww, Ww, Ss, Ss, Gd^Fp, Ds, Gd^Fmw, Gd, Rb^Edb, Rb^Edb, Gll^Fp, Ss, Ss
Gs, Gs, Gs, Gd^Fp, Gd^Fp, Gd^Fp, Gs, Gs^Fms, Gs, Gd^Fp, Gd^Fp, Gd, Gd^Fp, Gd^Fp, Gd^Fp, Gd^Fmw, Gd^Fp, Ss, Gd^Fp, Ss, Ss, Gd^Fp, Ss, Ss, Gd^Fp, Gd^Fmw, Ss, Ss^Vhs, Ss^Em, Ss^Em, Ss, Ww, Ww, Ss, Ss, Ss, Ds, Gd, Ds, Gd, Re, Rb, 4 Re^Edb, Ss
Gs, Gs, Gs, Gs, Gs, Gs, Gs, Gs, Gs, Gs, Gd, Gd, Gd^Fp, Gd^Fp, Gd^Fmw, Gd^Fmw, Gd^Fp, Gd^Fmw, Gd^Fp, Ss, Ss, Ss, Gll^Fp, Ss, Gd^Fp, Gd^Fp, Ss, Ss, Ss, Ss, Ss, Ss, Ww, Ss, Ss, Ds, Ds, Ds, Ds, Ds, Re, Re, Re, Re
