Ss, Ss, Ss, Ss, Wog, Ss, Ss, Ss, Ss, Gll^Fp, Gll^Fmw, Gll^Fp, Gll^Fp, Ss, Ss, Wog, Wog, Wog, Wog, Wog, Ss, Ss, Ss, Gll^Fp, Gll^Fmw, Gll^Fmw, Gll^Fdw, Gll^Fp, Gll^Fp, Gg, Gll^Fp, Gll^Fp, Gll^Fp, Gll^Fp, Gll^Fp, Gll^Fp, Gll^Fp, Gll^Fmw, Gll^Fp, Gll^Fp, Gll^Fp, Gll^Fmw, Gll^Fp
Ss, 5 Ss^Vhs, Ss, Ss, Ss, Wog, Wog, Ss, Ss^Vhs, Gll^Fp, Gll^Fp, Gll^Fmw, Ss, Ss, Ss, Wog, Wog, Wog, Ss, Wog, Ss^Edb, Ss, Ss, Gll^Fdw, Gs^Vc, Gs, Gs, Gll^Fmw, Gll^Fp, Gll^Fmw, Gll^Fp, Gll^Fp, Gll^Fp, Gll^Fp, Gll^Fp, Gll^Fp, Ss, Ss, Ss, Gll^Fp, Gll^Fmw, Gll^Fp, Gll^Fmw
Gll^Fp, Ss, Gll^Fp, Ss, Ss, Ss, Ss, Ss, Gs, Gs, Gs^Em, Gll^Fp, Gll^Fp, Ss^Edb, Ss, Wog, Ss, Ss, Gll^Fp, Ss, Ss, Ss, Gs, Gll^Fp, Gll^Fp, Gs, Ss, Ss, Ss^Edb, Gll^Fp, Ss, Ss, Gll^Fp, Gll^Fp, Gs^Vl, Gll^Fp, Ss, Wog, Ss, Gll^Fp, Ss, Gll^Fp, Gll^Fp
Gll^Fmw, Gll^Fmw, Gll^Fp, Gll^Fp, Gll^Fp, Ss, Gll^Fp, Gll^Fp, Gll^Fp, Gll^Fp, Ss, Gll^Fp, Gll^Fp, Gll^Fmw, Gs^Em, Ss, Gs, Ss, Gs, Gll^Fmw, Gs, Ss, Gs, Ss, Ss, Gs, Ss, Ss^Edb, Wog, Ss, Ss, Ss, Ss, Gs^Em, Gs, Gll^Fmw, Ss, Wog, Wog, Ss, Ss, Gll^Fmw, Gll^Fmw
Gll^Fmw, Gll^Fp, Ce, Gll^Fp, Ce, Gll^Fmw, Gll^Fp, Gll^Fmw, Ss, Ss, Ss, Ss, Ss, Gs, Gs, Gs, Gs, Gs, Gll^Fp, Gll^Fp, Re, Gll^Fp, Gs, Ss, Ss, Ss, Ss, Ss^Edb, Wog, Wog, Wog, Ss, Ss, Gs, Gs, Ss, Wog, Wog, Wog, Wog, Ss, Gll^Fmw, Gll^Fmw
Gll^Fp, Gll^Fmw, Gll^Fp, Ke, Ce, Gll^Fp, Gll^Fp, Gll^Fp, Ss, Ss, Wog, Wog, Ss, Ss, Ss, Ss, Ss, Ss, Gs, Gs^Vc, Gs, Re, Re, Ss, Ss, Ss, Wog, Wog, Wog, Ss, Ss, Ss, Ss^Bw/r, Ss^Bw/r, Ss, Ss, Wog, Wog, Wog, Ss, Ss, Ss, Gll^Fp
Gll^Fp, Gll^Fp, Gll^Fp, Ce, Gll^Fmw, Gll^Fmw, Gll^Fp, Ss, Ww^Vm, Wog, Wog, Wog, Wog, Wog, Ss, Ss, Ss, Gll^Fp, Gs, Gs, Ss, Ss, Ss, Ss^Bw\r, Gs, Ss, Ss, Ss, Ss, Ss, Ss, Gs, Gs, Ss, Ss, Wog, Wog, Wog, Ss, Ss, Gll^Fmw, Gll^Fdw, Gll^Fmw
Gll^Fmw, Gll^Fp, Gll^Fp, Gll^Fp, Gll^Fp, Gll^Fmw, Gll^Fp, Ss, Ss, Wog, Ss, Wog, Wog, Wog, Ss, Gs, Gs, Gll^Fp, Gs, Ss, Wog, Wog, Ss, Gs, Gs, Ss, Ss, Ss, Gs^Em, Gs, Gs, Gs, Ss, Ss^Vhs, Ss, Ss, Ss, Ss, Gll^Fp, Ss, Gll^Fp, Gll^Fmw, Ss
Gll^Fp, Gll^Fp, Gll^Fp, Gll^Fmw, Gll^Fmw, Gll^Fp, Gll^Fp, Gll^Fp, Gs^Em, Ss, Ss, Wog, Ss, Ss^Edb, Ss, Gs, Gs, Gs, Gll^Fp, Ss, Wog, Ss, Ss, Gs, Ss, Rb, Rb, Gs^Em, Rb, Rb, Ss, Ss, Ss, Ss^Edb, Ss, Gs^Em, Gll^Fmw, Gll^Fp, Gll^Fmw, Gll^Fp, Ss, Ss, Ss
Gll^Fp, Gll^Fp, Gll^Fp, Gll^Fdw, Ss, Ss, Ss, Ss, Gs, Gs, Ss, Wog, Ss, Ss, Ss, Gll^Fp, Gll^Fp, Gs, Gs, Ss, Ss, Ss, Ss^Vhs, Ss, Ss, Rb^Em, Rb, Gs^Vht, Rb, Gs, Gs, Ss, Wog, Wog, Ss, Gs, Gs, Gs^Vc, Gs, Ss, Ss, Ss, Wog
Gll^Fmw, Gll^Fp, Gs^Vl, Gll^Fp, Ss, Ss, Wog, Ss, Gll^Fp, Gll^Fp, Gs, Ss, Gs^Em, Ss, Gs, Gs^Vht, Gll^Fp, Gs, Gd^Fetd, Gs, Gs, Gs, Ss^Edb, Ss^Edb, Ss^Edb, Ss, Rb, Rb, Gs, Gs^Em, Ss^Edb, Ss^Edb, Wog, Ss, Wog, Ss, Ss, Gs^Em, Ss, Ss, Ss, Wog, Wog
Gg, Gs, Gs, Gs, Ss, Ss, Wog, Ss, Gll^Fp, Ss, Ss^Vhs, Ss^Bw\r, Rb, Gs, Gs, Gs, Ss, Rb^Em, Gs, Gs, Ss, Ss, Wog, Wog, Ss, Ss, Rb, Gs, Ss, Ss^Edb, Wog, Wog, Wog, Wog, Wog, Ss, Ss, Gll^Fp, Ss, Ss, Wog, Wog, Wog
Ss, Ss, Ss, Sm^Bw\r, Sm^Bw|, Wog, Ss, Ss^Edb, Ss, Ss, Ss, Gs, Rb, Gll^Fmw, Gll^Fp, Gs, Ss, Rb^Em, Rb, Gs, Gll^Fmw, Ss, Ss, Wog, Ss, Gs^Em, Gs, Rb, Ss, Ss^Edb, Ss^Edb, Wog, Ss, Ss, Wog, Ss, Ss, Gll^Fmw, Gll^Fmw, Ss, Wog, Wog, Wog
Ss, Ss, Ss, Ss, Wog, Wog, Wog, Wog, Wog, Wo, Ss, Gs, Rb^Em, Ss, Ss, Ss^Edb, Sm, Ss, Gll^Fmw, Rb, Gs^Em, Ss, Ss, Wog, Wwg, Ss, Ss, Rb, Ss, Ss, Ss, Ss, Ss, Ss^Edb, Ss^Edb, Ss, Gll^Fp, Gll^Fmw, Gll^Fp, Ss, Ss, Ss, Wog
Ss, Wo, Ss, Ss, Sm^Bw|, Ss, Ss, Wog, Ss, Ss, Gs^Em, Gs, Rb^Em, Ss, Sm, Wog, Sm, Ss^Edb, Ss, Rb, Rb, Ss, Ss, Wwg, Ss, Ss, Ss^Vhs, Ss^Bw|r, Gs, Gs, Gs, Ss, Gs, Gs, Gs, Ss, Rb, Rb, Gs, Ss, Ss, Ss, Ss
Wo, Wo, Ss, Ss, Rb, Ss, Ss, Wog, Ss, Gll^Fp, Gs, Rb, Ss, Ss^Vhs, Sm, Wog, Wog, Wog, Ss, Ss, Ss, Rb, Gs^Fms, Ss, Gs, Gs, Gs, Rb, 1 Rb, 2 Rb, Gs, Gs, Rb, Rb, Rb, Rb, Ss, Gll^Fp, Gs, Gll^Fp, Gll^Fp, Ss, Ss
Wwg, Ss, Ss, Ss, Rb, Ss, Ss, Ss, Gll^Fp, Gll^Fmw, Gs, Gs, Ss, Sm, Wog, Wog, Wog, Wog, Ss^Edb, Ss, Gs, Ss^Vhs, Gs^Fms, Ss, Gs, Gs, Rb, Rb, Gs, Gs, Gs, Gs, Ss, Gs^Vhs, Gs^Em, Ss, Ss, Ss, Ss, Gs, Gll^Fp, Ss, Gll^Fp
Ss, Wwg, Wwg, Ss^Edb, Ss, Gd^Fetd, Gll^Fp, Gs^Vht, Gll^Fp, Gs^Em, Gs, Ss, Rb, Ss, Ss, Ss, Ss, Ss^Edb, Gs^Em, Ss, Gs, Gs, Gs, Gs^Fms, Gs, Gs^Fms, Gs^Fms, Gs^Fms, Ss, Ss, Ss, Ss, Ss^Edb, Ss, Gll^Fp, Gll^Fp, Ss, Wog, Ss, Ss, Gs^Vht, Gll^Fp, Gll^Fp
Gll^Fmw, Ss, Ss, Ss, Gs, Rb, Rb, Rb^Em, Gs^Em, Gs, Gs, Ss^Bw/r, Ss, Rb, Rb^Em, Gs, Gs, Ss, Gs, Gs, Gs, Ce, Gs, Gs^Efm, Rb, Ce, Gs^Fms, Ss, Ss, Wog, Wog, Wog, Ss^Edb, Ss^Edb, Gll^Fp, Ss, Wog, Wog, Ss^Edb, Ss, Ss, Gll^Fmw, Gll^Fp
Gll^Fp, Gll^Fmw, Gll^Fp, Gll^Fp, Ss, Ss, Ss, Gs, Gll^Fp, Gs, Ss, Ss, Ss, Ss^Vhs, Ss, Rb, Ss, Gs, Gs^Fms, Gs^Efm, Ce, Ce, 3 Ke, Rb, Ke, Ce, Gs^Fms, Gs^Fms, Ss, Wog, Wog, Wog, Ss, Gs, Gs, Ss, Wog, Wog, Wog, Ss^Edb, Ss, Ss, Gg
Gll^Fmw, Gd^Fetd, Ss, Ss, Ss, Wog, Ss, Gll^Fp, Ss, Gll^Fp, Ss, Ss, Wog, Ss, Ss, Ss, Gll^Fp, Gs^Fms, Gs^Vl, Gs, Ce, Rb, Rb, Rb, Rb, Ce, Gs^Fms, Gs^Fms, Gs^Fms, Ss, Wog, Ss, Gs^Fms, Gs^Fms, Ss, Ww^Vm, Wog, Wog, Ss, Ss, Ss, Ss, Gll^Fmw
Gll^Fp, Gll^Fp, Ss^Vhs, Ss, Ss, Wog, Ss, Ss, Ww^Vm, Ss, Ss, Ss, Ss, Wog, Ss, Ss, Gll^Fmw, Gs^Fms, Gs^Fms, Gs, Gs, Ce, Rb, Re^Vct, Rb, Ce, Ce, Gs^Fms, Ss, Ss, Ss, Ss^Edb, Gs^Fms, Ss, Sm, Wog, Wog, Ss, Gs^Em, Ss, Gll^Fmw, Gll^Fdw, Gll^Fp
Gll^Fp, Ss, Gll^Fp, Ss, Ss, Wog, Wog, Wog, Wog, Ss, Gll^Fmw, Gll^Fp, Ss, Wog, Ss, Ss, Ss, Gs^Fms, Gs^Fms, Gs, Gs, Gs, Gs, Gs, Rb, Gs^Fms, Gs^Fms, Gs^Fms, Gs, Gs^Fms, Gs^Vhs, Ss^Edb, Ss, Sm, Sm, Sm, Ss, Ss, Gs, Gs^Em, Gll^Fmw, Gll^Fp, Gll^Fp
Gll^Fmw, Gll^Fp, Gll^Fp, Ss, Wog, Wog, Ss^Edb, Wog, Ss, Ss, Gll^Fmw, Ss, Gs, Ss, Gs^Vht, Ss, Gll^Fp, Gll^Fp, Gs, Ss, Ss, Ss, Ss, Gs, Gs, Rb, Gs, Gs^Efm, Gs^Fms, Rb, Rb, Rb, Ss^Bw\r, Ss, Ss, Ss, Rb, Gs, Ss, Gll^Fp, Ss, Ss, Ss
Gll^Fmw, Gll^Fp, Ss, Ss, Wog, Ss^Edb, Ss, Ss, Ss, Ss, Gs^Em, Gs, Gll^Fmw, Gs, Gs, Gs, Gs, Gs, Ss, Ss, Wog, Wog, Ss, Gll^Fp, Rb, Rb, Ss^Vhs, Gs, Ss, Ss, Ss, Ss, Ss, Ss, Rb, Rb, Gs^Vhs, Ss, Ss, Ss, Ss, Wog, Wog
Gll^Fmw, Ss, Ss, Ss, Ss, Ss, Rb, Ss, Ss, Ss, Rb, Gll^Fp, Ss, Ss, Ss, Ss, Ss, Gs, Ss, Wog, Ss, Wog, Ss, Rb, Gll^Fp, Gll^Fp, Ss, Ss, Wog, Wog, Sm, Sm, Ss, Ss, Ss, Ss, Ss, Ss, Ss, Ss, Wog, Wog, Wog
Gll^Fp, Gll^Fp, Gll^Fmw, Gs, Ss^Bw/r, Ss^Bw/, Gll^Fp, Rb, Rb, Rb, Gll^Fdw, Gll^Fp, Ss, Ss, Ss, Wog, Ss, Gs, Gs, Ss, Ss, Ss, Gll^Fp, Rb, Gll^Fmw, Ss, Gs, Ss, Ss, Wog, Wog, Sm, Sm, Ss, Ss, Ss, Gll^Fmw, Ss, Ss, Ss, Sm, Wog, Sm
Gll^Fp, Gll^Fp, Gs^Vht, Gs, Ss, Gll^Fmw, Gll^Fp, Gll^Fmw, Gs^Em, Gs, Gs, Ss, Sm, Ss, Wog, Wog, Ss, Gs, Gll^Fmw, Gs, Gs^Em, Ss, Gll^Fp, Rb, Gs, Ss, Gs^Em, Gs, Ss, Ss^Edb, Ss, Ss, Ss, Ss, Gs^Em, Ss, Gll^Fmw, Gll^Fmw, Gll^Fmw, Ss, Sm, Sm, Sm
Gll^Fp, Gll^Fmw, Gll^Fp, Gs^Em, Ss, Ss, Gll^Fmw, Gs^Em, Ss, Ss^Vhs, Ss, Ss, Sm, Wog, Wog, Ss, Wog, Ss, Ss, Gll^Fp, Gs, Gs, Gs, Gs, Ss^Vhs, Ss, Ss, Ss, Gll^Fp, Gll^Fmw, Gs, Ss, Gs, Gs, Gs, Gll^Fp, Rb, Gll^Fp, Ce, Ce, Ss, Ss^Vhs, Ss
Ss, Ss, Ss, Ss, Wog, Ss, Ss, Gs, Gs, Ss, Ss, Sm, Wog, Wog, Wog, Wog, Wog, Wog, Ss, Ss, Rb, Rb, Ss, Ss, Ss, Gs, Gll^Fmw, Ss, Gs, Gs, Ss, Gs, Ss^Vhs, Gll^Fp, Gs, Gll^Fp, Rb, Ce, Ke, Ce, Gll^Fmw, Gll^Fp, Gll^Fp
Ss, Ss, Ss, Ss, Wog, Ss, Gll^Fp, Gll^Fmw, Gs, Ss, Ss^Edb, Wog, Sm, Sm, Ss^Edb, Ss^Edb, Ss, Ss, Ss, Gll^Fp, Rb, Ss, Wog, Ss^Edb, Ss, Gs, Gs, Gs, Ss, Gs^Em, Ss, Ss^Edb, Ss, Gll^Fp, Gll^Fp, Rb, Rb, Ce, Ce, Rb, Gll^Fmw, Gll^Fmw, Gll^Fmw
Ss, Ss, Wog, Wog, Wog, Ss, Ss, Gll^Fp, Gll^Fmw, Ss, Ss, Ss, Ss, Ss, Gll^Fp, Gll^Fp, Ss, Ss^Vhs, Rb, Rb^Em, Ss^Edb, Ss, Wog, Sm, Ss, Gll^Fp, Gs^Em, Gs^Em, Ss, Ss, Wog, Ss^Edb, Ss, Ss, Ss, Gll^Fmw, Gll^Fp, Rb, Rb, Rb, Gll^Fp, Gd^Em, Gll^Fmw
Ss, Ss, Wog, Wog, Wog, Wog, Ss, Ss, Gll^Fp, Gll^Fmw, Gs, Gs, Gll^Fp, Gll^Fp, Gll^Fmw, Gs, Gll^Fmw, Rb, Ss, Ss, Ss^Edb, Wog, Ss^Edb, Sm, Ss, Gll^Fmw, Gs, Ss, Ss, Ss^Edb, Wog, Wog, Wog, Ss^Edb, Ss, Ss, Gll^Fdw, Gll^Fp, Gll^Fp, Rb, Rb, 4 Gd, Gd
Ss, Wog, Wog, Wog, Wog, Wog, Ss, Gll^Fp, Gll^Fp, Gll^Fp, Gs, Gs, Gll^Fp, Gll^Fp, Gll^Fp, Gll^Fp, Gll^Fmw, Gll^Fp, Ss, Ss, Ss, Ss, Ss, Ss, Gg, Gll^Fp, Gg, Ss, Ss, Wog, Wog, Wog, Wog, Ss, Ww, Ss, Gll^Fdw, Gll^Fmw, Gll^Fmw, Rb, Rb, Gd, Gd
