Ss, Ss, Ss, Ss, Wog, Ss, Ss, Ss, Ss, Gll^Fp, Gll^Fmw, Gll^Fp, Gll^Fp, Ss, Ss, Wog, Wog, Wog, Wog, Wog, Ss, Ss, Ss, Gll^Fp, Gll^Fmw, Gll^Fmw, Gll^Fdw, Gll^Fp, Gll^Fp, Gg, Gll^Fp, Gll^Fp, Gll^Fp, Gll^Fp, Gll^Fp, Gll^Fp, Gll^Fp, Gll^Fmw, Gll^Fp, Gll^Fp, Gll^Fp, Gll^Fmw, Gll^Fp
Ss, 5 Ss^Vhs, Ss, Ss, Ss, Wog, Wog, Ss, Ss^Vhs, Gll^Fp, Gll^Fp, Gll^Fmw, Ss, Ss, Ss, Wog, Wog, Wog, Ss, Wog, Ss^Edb, Ss, Ss, Gll^Fdw, Gs^Vc, Gs, Gs, Gll^Fmw, Gll^Fp, Gll^Fmw, Gll^Fp, Gll^Fp, Gll^Fp, Gll^Fp, Gll^Fp, Gll^Fp, Ss, Ss, Ss, Gll^Fp, Gll^Fmw, Gll^Fp, Gll^Fmw
Gll^Fp, Ss, Gll^Fp, Ss, Ss, Ss, Ss, Ss, Gs, Gs, Gs, Gll^Fp, Gll^Fp, Ss^Edb, Ss, Wog, Ss, Ss, Gll^Fp, Ss, Ss, Ss, Gs, Gll^Fp, Gll^Fp, Gs, Ss, Ss, Ss^Edb, Gll^Fp, Ss, Ss, Gll^Fp, Gll^Fp, Gs^Vl, Gll^Fp, Ss, Wog, Ss, Gll^Fp, Ss, Gll^Fp, Gll^Fp
Gll^Fmw, Gll^Fmw, Gll^Fp, Gll^Fp, Gll^Fp, Ss, Gll^Fp, Gll^Fp, Gll^Fp, Gll^Fp, Ss, Gll^Fp, Gll^Fp, Gll^Fmw, Gs, Ss, Gs, Ss, Gs, Gll^Fmw, Gs, Ss, Gs, Ss, Ss, Gs, Ss, Ss^Edb, Wog, Ss, Ss, Ss, Ss, Gs, Gs, Gll^Fmw, Ss, Wog, Wog, Ss, Ss, Gll^Fmw, Gll^Fmw
Gll^Fmw, Gll^Fp, Ce, Gll^Fp, Ce, Gll^Fmw, Gll^Fp, Gll^Fmw, Ss, Ss, Ss, Ss, Ss, Gs, Gs, Gs, Gs, Gs, Gll^Fp, Gll^Fp, Gs, Gll^Fp, Gs, Ss, Ss, Ss, Ss, Ss^Edb, Wog, Wog, Wog, Ss, Ss, Gs, Gs, Ss, Wog, Wog, Wog, Wog, Ss, Gll^Fmw, Gll^Fmw
Gll^Fp, Gll^Fmw, Gll^Fp, Ke, Ce, Gll^Fp, Gll^Fp, Gll^Fp, Ss, Ss, Wog, Wog, Ss, Ss, Ss, Ss, Ss, Ss, Gs, Gs^Vc, Gs, Gs, Gs, Ss, Ss, Ss, Wog, Wog, Wog, Ss, Ss, Ss, Ss^Bw/r, Ss^Bw/r, Ss, Ss, Wog, Wog, Wog, Ss, Ss, Ss, Gll^Fp
Gll^Fp, Gll^Fp, Gll^Fp, Ce, Gll^Fmw, Gll^Fmw, Gll^Fp, Ss, Ww^Vm, Wog, Wog, Wog, Wog, Wog, Ss, Ss, Ss, Gll^Fp, Gs, Gs, Ss, Ss, Ss, Ss^Bw\r, Gs, Ss, Ss, Ss, Ss, Ss, Ss, Gs, Gs, Ss, Ss, Wog, Wog, Wog, Ss, Ss, Gll^Fmw, Gll^Fdw, Gll^Fmw
Gll^Fmw, Gll^Fp, Gll^Fp, Gll^Fp, Gll^Fp, Gll^Fmw, Gll^Fp, Ss, Ss, Wog, Ss, Wog, Wog, Wog, Ss, Gs, Gs, Gll^Fp, Gs, Ss, Wog, Wog, Ss, Gs, Gs, Ss, Ss, Ss, Gs, Gs, Gs, Gs, Ss, Ss, Ss, Ss, Ss, Ss, Gll^Fp, Ss, Gll^Fp, Gll^Fmw, Ss
Gll^Fp, Gll^Fp, Gll^Fp, Gll^Fmw, Gll^Fmw, Gll^Fp, Gll^Fp, Gll^Fp, Gs, Ss, Ss, Wog, Ss, Ss^Edb, Ss, Gs, Gs, Gs, Gll^Fp, Ss, Wog, Ss, Ss, Gs, Ss, Gs, Gs, Gs, Gs, Gs, Ss, Ss, Ss, Ss^Edb, Ss, Gs, Gll^Fmw, Gll^Fp, Gll^Fmw, Gll^Fp, Ss, Ss, Ss
Gll^Fp, Gll^Fp, Gll^Fp, Gll^Fdw, Ss, Ss, Ss, Ss, Gs, Gs, Ss, Wog, Ss, Ss, Ss, Gll^Fp, Gll^Fp, Gs, Gs, Ss, Ss, Ss, Ss^Edb, Ss, Ss, Gs, Gs, Gs^Vht, Gs, Gs, Gs, Ss, Wog, Wog, Ss, Gs, Gs, Gs^Vc, Gs, Ss, Ss, Ss, Wog
Gll^Fmw, Gll^Fp, Gs^Vl, Gll^Fp, Ss, Ss, Wog, Ss, Gll^Fp, Gll^Fp, Gs, Ss, Gs, Ss, Gs, Gs^Vht, Gll^Fp, Gs, Gd^Fetd, Gs, Gs, Gs, Ss^Edb, Ss^Edb, Ss^Edb, Ss, Gs, Gs, Gs, Gs, Ss^Edb, Ss^Edb, Wog, Ss, Wog, Ss, Ss, Gs, Ss, Ss, Ss, Wog, Wog
Gg, Gs, Gs, Gs, Ss, Ss, Wog, Ss, Gll^Fp, Ss, Ss^Vhs, Ss^Bw\r, Gs, Gs, Gs, Gs, Ss, Gs, Gs, Gs, Ss, Ss, Wog, Wog, Ss, Ss, Gs, Gs, Ss, Ss^Edb, Wog, Wog, Wog, Wog, Wog, Ss, Ss, Gll^Fp, Ss, Ss, Wog, Wog, Wog
Ss, Ss, Ss, Sm^Bw\r, Sm^Bw|, Wog, Ss, Ss^Edb, Ss, Ss, Ss, Gs, Gs, Gll^Fmw, Gll^Fp, Gs, Ss, Gs, Gs, Gs, Gll^Fmw, Ss, Ss, Wog, Ss, Gs, Gs, Gs, Ss, Ss^Edb, Ss^Edb, Wog, Ss, Ss, Wog, Ss, Ss, Gll^Fmw, Gll^Fmw, Ss, Wog, Wog, Wog
Ss, Ss, Ss, Ss, Wog, Wog, Wog, Wog, Wog, Wo, Ss, Gs, Gs, Ss, Ss, Ss^Edb, Sm, Ss, Gll^Fmw, Gs, Gs, Ss, Ss, Wog, Wwg, Ss, Ss, Gs, Ss, Ss, Ss, Ss, Ss, Ss^Edb, Ss^Edb, Ss, Gll^Fp, Gll^Fmw, Gll^Fp, Ss, Ss, Ss, Wog
Ss, Wo, Ss, Ss, Sm^Bw|, Ss, Ss, Wog, Ss, Ss, Gs, Gs, Gs, Ss, Sm, Wog, Sm, Ss^Edb, Ss, Gs, Gs, Ss, Ss, Wwg, Ss, Ss, Ss^Vhs, Ss^Bw|r, Gs, Gs, Gs, Ss, Gs, Gs, Gs, Ss, Gs, Gs, Gs, Ss, Ss, Ss, Ss
Wo, Wo, Ss, Ss, Re, Ss, Ss, Wog, Ss, Gll^Fp, Gs, Gs, Ss, Ss^Vhs, Sm, Wog, Wog, Wog, Ss, Ss, Ss, Gs, Gs^Fms, Ss, Gs, Gs, Gs, Gs, 1 Gs, 2 Gs, Gs, Gs, Gs, Gs, Gs, Gs, Ss, Gll^Fp, Gs, Gll^Fp, Gll^Fp, Ss, Ss
Wwg, Ss, Ss, Ss, Re, Ss, Ss, Ss, Gll^Fp, Gll^Fmw, Gs, Gs, Ss, Sm, Wog, Wog, Wog, Wog, Ss^Edb, Ss, Gs, Ss^Vhs, Gs^Fms, Ss, Gs, Gs, Gs, Gs, Gs, Gs, Gs, Gs, Ss, Gs^Vhs, Gs^Em, Ss, Ss, Ss, Ss, Gs, Gll^Fp, Ss, Gll^Fp
Ss, Wwg, Wwg, Ss^Edb, Ss, Gd^Fetd, Gll^Fp, Gs^Vht, Gll^Fp, Gs, Gs, Ss, Gs, Ss, Ss, Ss, Ss, Ss^Edb, Gs, Ss, Gs, Gs, Gs, Gs^Fms, Gs, Gs^Fms, Gs^Fms, Gs^Fms, Ss, Ss, Ss, Ss, Ss^Edb, Ss, Gll^Fp, Gll^Fp, Ss, Wog, Ss, Ss, Gs^Vht, Gll^Fp, Gll^Fp
Gll^Fmw, Ss, Ss, Ss, Gs, Gs, Gs, Gs, Gs, Gs, Gs, Ss^Bw/r, Ss, Gs, Gs, Gs, Gs, Ss, Gs, Gs, Gs, Ce, Gs, Gs, Rd, Ce, Gs^Fms, Ss, Ss, Wog, Wog, Wog, Ss^Edb, Ss^Edb, Gll^Fp, Ss, Wog, Wog, Ss^Edb, Ss, Ss, Gll^Fmw, Gll^Fp
Gll^Fp, Gll^Fmw, Gll^Fp, Gll^Fp, Ss, Ss, Ss, Gs, Gll^Fp, Gs, Ss, Ss, Ss, Ss^Vhs, Ss, Gs, Ss, Gs, Gs^Fms, Gs, Ce, Ce, 3 Ke, Rd, Ke, Ce, Gs^Fms, Gs^Fms, Ss, Wog, Wog, Wog, Ss, Gs, Gs, Ss, Wog, Wog, Wog, Ss^Edb, Ss, Ss, Gg
Gll^Fmw, Gd^Fetd, Ss, Ss, Ss, Wog, Ss, Gll^Fp, Ss, Gll^Fp, Ss, Ss, Wog, Ss, Ss, Ss, Gll^Fp, Gs^Fms, Gs^Vl, Gs, Ce, Rd, Rd, Rd, Rd, Ce, Gs^Fms, Gs^Fms, Gs^Fms, Ss, Wog, Ss, Gs^Fms, Gs^Fms, Ss, Ww^Vm, Wog, Wog, Ss, Ss, Ss, Ss, Gll^Fmw
Gll^Fp, Gll^Fp, Ss^Vhs, Ss, Ss, Wog, Ss, Ss, Ww^Vm, Ss, Ss, Ss, Ss, Wog, Ss, Ss, Gll^Fmw, Gs^Fms, Gs^Fms, Gs, Gs, Ce, Rd, Rd^Vct, Rd, Ce, Ce, Gs^Fms, Ss, Ss, Ss, Ss^Edb, Gs^Fms, Ss, Sm, Wog, Wog, Ss, Gs, Ss, Gll^Fmw, Gll^Fdw, Gll^Fp
Gll^Fp, Ss, Gll^Fp, Ss, Ss, Wog, Wog, Wog, Wog, Ss, Gll^Fmw, Gll^Fp, Ss, Wog, Ss, Ss, Ss, Gs^Fms, Gs^Fms, Gs, Gs, Gs, Gs, Gs, Rd, Gs^Fms, Gs^Fms, Gs^Fms, Gs, Gs^Fms, Gs^Vhs, Ss^Edb, Ss, Sm, Sm, Sm, Ss, Ss, Gs, Gs, Gll^Fmw, Gll^Fp, Gll^Fp
Gll^Fmw, Gll^Fp, Gll^Fp, Ss, Wog, Wog, Ss^Edb, Wog, Ss, Ss, Gll^Fmw, Ss, Gs, Ss, Gs^Vht, Ss, Gll^Fp, Gll^Fp, Gs, Ss, Ss, Ss, Ss, Gs, Gs, Rd, Gs, Gs, Gs^Fms, Gs, Gs, Gs, Ss^Bw\r, Ss, Ss, Ss, Gs, Gs, Ss, Gll^Fp, Ss, Ss, Ss
Gll^Fmw, Gll^Fp, Ss, Ss, Wog, Ss^Edb, Ss, Ss, Ss, Ss, Gs, Gs, Gll^Fmw, Gs, Gs, Gs, Gs, Gs, Ss, Ss, Wwg, Ww^Vm, Ss, Gll^Fp, Gs, Gs, Ss^Vhs, Gs, Ss, Ss, Ss, Ss, Ss, Ss, Gs, Gs, Gs^Vhs, Ss, Ss, Ss, Ss, Wog, Wog
Gll^Fmw, Ss, Ss, Ss, Ss, Ss, Gs, Ss, Ss, Ss, Gs, Gll^Fp, Ss, Ss, Ss, Ss, Ss, Gs, Ss, Wwg, Ss, Ss, Ss, Gs, Gll^Fp, Gll^Fp, Ss, Ss, Wog, Wog, Sm, Sm, Ss, Ss, Ss, Ss, Ss, Ss, Ss, Ss, Wog, Wog, Wog
Gll^Fp, Gll^Fp, Gll^Fmw, Gs, Ss^Bw/r, Ss^Bw/, Gll^Fp, Gs, Gs, Gs, Gll^Fdw, Gll^Fp, Ss, Ss, Ss, Wog, Ss, Gs, Gs, Ss, Ss, Ss, Gll^Fp, Gs, Gll^Fmw, Ss, Gs, Ss, Ss, Wog, Wog, Sm, Sm, Ss, Ss, Ss, Gll^Fmw, Ss, Ss, Ss, Sm, Wog, Sm
Gll^Fp, Gll^Fp, Gs^Vht, Gs, Ss, Gll^Fmw, Gll^Fp, Gll^Fmw, Gs, Gs, Gs, Ss, Sm, Ss, Wog, Wog, Ss, Gs, Gll^Fmw, Gs^Vht, Gs, Ss, Gll^Fp, Gs, Gs, Ss, Gs, Gs, Ss, Ss^Edb, Ss, Ss, Ss, Ss, Gs, Ss, Gll^Fmw, Gll^Fmw, Gll^Fmw, Ss, Sm, Sm, Sm
Gll^Fp, Gll^Fmw, Gll^Fp, Gs, Ss, Ss, Gll^Fmw, Gs, Ss^Vhs, Ss, Ss, Ss, Sm, Wog, Wog, Ss, Wog, Ss, Ss, Gll^Fp, Gs, Gs, Gs, Gs, Ss^Vhs, Ss, Ss, Ss, Gll^Fp, Gll^Fmw, Gs, Ss, Gs, Gs, Gs, Gll^Fp, Rd, Gll^Fp, Ce, Ce, Ss, Ss^Vhs, Ss
Ss, Ss, Ss, Ss, Wog, Ss, Ss, Gs, Gs, Ss, Ss, Sm, Wog, Wog, Wog, Wog, Wog, Wog, Ss, Ss, Gs, Gs, Ss, Ss, Ss, Gs, Gll^Fmw, Ss, Gs, Gs, Ss, Gs, Ss^Vhs, Gll^Fp, Gs, Gll^Fp, Rd, Ce, Ke, Ce, Gll^Fmw, Gll^Fp, Gll^Fp
Ss, Ss, Ss, Ss, Wog, Ss, Gll^Fp, Gll^Fmw, Gs, Ss, Ss^Edb, Wog, Sm, Sm, Ss^Edb, Ss^Edb, Ss, Ss, Ss, Gll^Fp, Gs, Ss, Wog, Ss^Edb, Ss, Gs, Gs, Gs, Ss, Gs, Ss, Ss^Edb, Ss, Gll^Fp, Gll^Fp, Rd, Rd, Ce, Ce, Rd, Gll^Fmw, Gll^Fmw, Gll^Fmw
Ss, Ss, Wog, Wog, Wog, Ss, Ss, Gll^Fp, Gll^Fmw, Ss, Ss, Ss, Ss, Ss, Gll^Fp, Gll^Fp, Ss, Ss^Vhs, Gs, Gs, Ss^Edb, Ss, Wog, Sm, Ss, Gll^Fp, Gs, Gs, Ss, Ss, Wog, Ss^Edb, Ss, Ss, Ss, Gll^Fmw, Gll^Fp, Rd, Rd, Rd, Gll^Fp, Gd, Gll^Fmw
Ss, Ss, Wog, Wog, Wog, Wog, Ss, Ss, Gll^Fp, Gll^Fmw, Gs, Gs, Gll^Fp, Gll^Fp, Gll^Fmw, Gs, Gll^Fmw, Gs, Ss, Ss, Ss^Edb, Wog, Ss^Edb, Sm, Ss, Gll^Fmw, Gs, Ss, Ss, Ss^Edb, Wog, Wog, Wog, Ss^Edb, Ss, Ss, Gll^Fdw, Gll^Fp, Gll^Fp, Rd, Rd, 4 Gd, Gd
Ss, Wog, Wog, Wog, Wog, Wog, Ss, Gll^Fp, Gll^Fp, Gll^Fp, Gs, Gs, Gll^Fp, Gll^Fp, Gll^Fp, Gll^Fp, Gll^Fmw, Gll^Fp, Ss, Ss, Ss, Ss, Ss, Ss, Gg, Gll^Fp, Gg, Ss, Ss, Wog, Wog, Wog, Wog, Ss, Ww, Ss, Gll^Fdw, Gll^Fmw, Gll^Fmw, Rd, Rd, Gd, Gd
