Wo, Wo, Wo, Wo, Wo, Wo, Wo, Wo, Wo, Wo, Wo, Wo, Wo, Wo, Wo, Wo, Wo, Wo, Wo, Wo, Wo, Wo, Wo, Wo, Wo, Wo, Wo, Wo, Wo, Wo, Wo, Wo, Wo, Wo, Wo
Wo, Wo, Wo, Wo, Wo, Wo, Wo, Wo, Wo, Wo, Wo, Wo, Wo, Wo, Wo, Wo, Wo, Wo, Wo, Wo, Wo, Wo, Wo, Wo, Wo, Wo, Wo, Wo, Wo, Wo, Wo, Wo, Wo, Wo, Wo
Wo, Wo, Wo, Wo, Wo, Wo, Wo, Wo, Wo, Wo, Wo, Wo, Wo, Wo, Wo, Wo, Wo, Wo, Wo, Wo, Wo, Wo, Wo, Wo, Wo, Wo, Wo, Wo, Wo, Wo, Wo, Wo, Wo, Wo, Wo
Wo, Wo, Wo, Wo, Wo, Wo, Wo, Wo, Wo, Wo, Wo, Wo, Wo, Wo, Wo, Wo, Wo, Wo, Wo, Wo, Wo, Wo, Wo, Wo, Wo, Wo, Wo, Wo, Wo, Wo, Wo, Wo, Wo, Wo, Wo
Ww, Wo, Ww, Ww, Ww, Wo, Wo, Wo, Ww, Wo, Wo, Ww, Wo, Wo, Ww, Ww, Ww, Ww, Ww, Ww, Wo, Wo, Wo, Wo, Wo, Wo, Wo, Wo, Wo, Wo, Wo, Wo, Wo, Wo, Wo
Ww, Ww, Ss, Ss, Ww, Ww, Ww, Ww, 2 Gg, Ww, Ww, Ww, Ww, Ww, Ww, Ds, Ww, Ds, Ww, Ww, Ww, Ww, Ww, Wo, Ww, Wo, Wo, Wo, Wo, Wo, Wo, Wo, Wo, Wo, Wo
Ds, Ss, Ss, Ds, Ds, Ds, Gg, 1 Gg, Gg, Gg, Ds, Ds, Ss, Ss, Ss, Ss, Ds, Ds, Gg, Gg, Gg, Ww, Ww, Ww, Ww, Ww, Ww, Ww, Ww, Ww, Ww, Wo, Ww, Ww, Ww
Gs^Fp, Ds, Gs^Fp, Ss, Ds, Ds, Ds, Gg, Gg, Gg, Gg, Gg, Ds, Ds, Ds, Ss, Gg, Gg, Gg, Gg, Gs^Fds, Gs^Fms, Gs^Fms, Ww, Gs^Fds, Ww, Ds, Ww, Ww, Ww, Ww, Ww, Ww, Ww, Ww
Gg, Gs^Fp, Gs^Fms, Gs^Fp, Ss, Ss, Ss, Gg, Gg, Gg, Hh, Gg, Gs^Fds, Gs^Fds, Ss, Gs^Fds, Gs^Fds, Gg, Gg, Gg, Gs^Fms, Gs^Fms, Gs^Fms, Gs^Fds, Gs^Fds, Gg, Ds, Ds, Gs^Fds, Ds, Ds, Ds, Ds, Ds, Ds
Gg, Gg, Gg, Ss, Hh, Gs^Fms, Gs^Fms, Gs^Fp, Gs^Fp, Ds, Hh, Hh, Hh, Gs^Fds, Gg, Gg, Gg, Gg, Gg, Gg, Gs^Fds, Gs^Fds, Gg, Gs^Fds, Gs^Fds, Gg, Gg, Gg, Gg, Hh, Gs^Fds, Gs^Fds, Gs^Fds, Gs^Fds, Gg
Gg, Gg, Gg, Gg, Gg, Gs^Fds, Gs^Fms, Gs^Fms, Gs^Fds, Gs^Fms, Gs^Fds, Gs^Fds, Gg, Gg, Gg, Gg, Gg, Gg, Gs^Fms, Gg, Gg, Gg, Gg, Gg, Gg, Gg, Gg, Gg, Hh, Gs^Fds, Gs^Fds, Gs^Fds, Gs^Fds, Gs^Fds, Gs^Fds
Gg, Gg, Gg, Gg, Gg, Gg, Gg, Gg, Gg, Gg, Gg, Gg, Gg, Gs^Fms, Gs^Fds, Gg, Gg, Gs^Fms, Gs^Fms, Gs^Fms, Gg, Gg, Gg, Gg, Gg, Gg, Gg, Hh, Hh, Hh, Gg, Gg, Gg, Gg, Gg
Gs^Fds, Gg, Gs^Fds, Gs^Fds, Gs^Fds, Gg, Gg, Gg, Gg, Gg, Gg, Gg, Gg, Gs^Fms, Gs^Fms, Gs^Fms, Gg, Gs^Fds, Gs^Fds, Gs^Fds, Gs^Fds, Gg, Gg, Gg, Gg, Gg, Gg, Gs^Fds, Gs^Fds, Gs^Fds, Gg, Gg, Gg, Gg, Gg
Gs^Fds, Gs^Fds, Gs^Fds, Gs^Fds, Gs^Fds, Gg, Gg, Gg, Gg, Gg, Gg, Gg, Gg, Gs^Fds, Gg, Gg, Gg, Gg, Gs^Fds, Gs^Fms, Gg, Gg, Gs^Fds, Gs^Fds, Gs^Fds, Gg, Gg, Gg, Gs^Fds, Gs^Fds, Gg, Gg, Gg, Gg, Gg
Hh, Gg, Gs^Fds, Gs^Fds, Gg, Gg, Gg, Gg, Gg, Gg, Gg, Gg, Gg, Gg, Hh, Hh, Hh, Gg, Gg, Gg, Gg, Gs^Fds, Gs^Fds, Gs^Fds, Gs^Fds, Gg, Gg, Gg, Gg, Gg, Gs^Fds, Gg, Gg, Gg, Gg
Hh, Gg, Gg, Gs^Fds, Gg, Gg, Gg, Gs^Fds, Gs^Fds, Gs^Fds, Gs^Fds, Gg, Hh, Hh, Mm, Gs^Fds, Gs^Fds, Hh, Gg, Gg, Gg, Gg, Gg, Gs^Fds, Gg, Gg, Gg, Gg, Gs^Fds, Hh, Gs^Fds, Gs^Fds, Gs^Fds, Gs^Fds, Gs^Fds
Hh, Hh, Hh, Gg, Gg, Gg, Gg, Gs^Fds, Gs^Fds, Gs^Fds, Gs^Fds, Gg, Hh, Mm, Mm, Mm, Gs^Fds, Hh, Gg, Gg, Gg, Gg, Gg, Gg, Gg, Gg, Gg, Gs^Fds, Hh, Hh, Gs^Fds, Gs^Fds, Gs^Fds, Gs^Fds, Gs^Fds
Hh, Hh, Gg, Gg, Gg, Gg, Gg, Gg, Gg, Gg, Gg, Gg, Gg, Hh, Gs^Fds, Hh, Gs^Fds, Gs^Fds, Gg, Gs^Fds, Gs^Fds, Gs^Fds, Gs^Fds, Gg, Gg, Gg, Gs^Fds, Hh, Hh, Gs^Fds, Gs^Fds, Gs^Fds, Gs^Fds, Gs^Fds, Gs^Fds
Gs^Fds, Gg, Gg, Gg, Gg, Gg, Gg, Hh, Gs^Fds, Hh, Gs^Fds, Gs^Fds, Gs^Fds, Gg, Gg, Gg, Gg, Gg, Gs^Fds, Gs^Fds, Gs^Fds, Gs^Fds, Gs^Fds, Gg, Gg, Gs^Fds, Gs^Fds, Hh, Gs^Fds, Gs^Fds, Gg, Gg, Hh, Gs^Fds, Hh
Gs^Fds, Gs^Fds, Gs^Fds, Gg, Gg, Gg, Gg, Ww, Ww, Hh, Gs^Fds, Gs^Fds, Gs^Fds, Gs^Fds, Gg, Gg, Gg, Gg, Gg, Gs^Fds, Gg, Gs^Fds, Gs^Fds, Gs^Fds, Gg, Gs^Fds, Gs^Fds, Gs^Fds, Gg, Gg, Gg, Gg, Ww, Ww, Hh
Gs^Fds, Gs^Fds, Gs^Fds, Gg, Gg, Gg, Hh, Hh, Ww, Gs^Fds, Gs^Fds, Gs^Fds, Gs^Fds, Gg, Gg, Re^Gvs, Gg, Gg, Gg, Gg, Gs^Fds, Gs^Fds, Gs^Fds, Gs^Fds, Gg, Gs^Fds, Gs^Fds, Gs^Fds, Gg, Gg, Gg, Hh, Hh, Ww, Gs^Fds
Gg, Gg, Gg, Re^Gvs, Re^Gvs, Re^Gvs, Gg, Gg, Hh, Gg, Gg, Gg, Gg, Re^Gvs, Re^Gvs, Gg, Gg, Re^Gvs, Gs^Fds, Gs^Fds, Gs^Fds, Gs^Fds, Gs^Fds, Gs^Fds, Gs^Fds, Gg, Gg, Gg, Re^Gvs, Re^Gvs, Re^Gvs, Gg, Gg, Hh, Gg
Gg, Gg, Gg, Gg, Re^Gvs, Re^Gvs, Re^Gvs, Re^Gvs, Gg, Gg, Gg, Gg, Re^Gvs, Re^Gvs, Re^Gvs, Gg, Re^Gvs, Re^Gvs, Gs^Fds, Gs^Fds, Gg, Gs^Fds, Gg, Gs^Fds, Gg, Gg, Gg, Gg, Gg, Re^Gvs, Re^Gvs, Re^Gvs, Re^Gvs, Gg, Gg
Gg, Gg, Gg, Gg, Re^Gvs, Gg, Gg^Vh, Re^Gvs, Re^Gvs, Gg, Gg, Gg, Re^Gvs, Gg, Gg, Re^Gvs, Re^Gvs, Re^Gvs, Gs^Fds, Gs^Fds, Gg, Gg, Gg, Gg, Gg, Gg, Gg, Gg, Gg, Re^Gvs, Gg, Gg^Vh, Re^Gvs, Re^Gvs, Gg
Gg, Gg, Gg, Gg, Gg, Gg, Gg, Gg, Gg, Gg, Gs^Fds, Gg, Gg, Gg, Gg, Gg, Hh, Gs^Fds, Gs^Fds, Gs^Fds, Gs^Fds, Gs^Fds, Gg, Gg, Gg, Gg, Gg, Gg, Gg, Gg, Gg, Gg, Gg, Gg, Gg
Gg, Gg, Gg, Gs^Fds, Gg, Re^Gvs, Re^Gvs, Gg, Gs^Fds, Gs^Fds, Gs^Fds, Ww, Ww, Ww, Ww, Hh, Hh, Gs^Fds, Gg, Re^Gvs, Gs^Fds, Hh, Gg, Gg, Gg, Gg, Ce, Gg, Ce, Ce, Ce, Re^Gvs, Gg, Gg, Gg
Gg, Gg, Gg, Gg, Gs^Fds, Re^Gvs, Re^Gvs, Gg, Gg, Gg, Gs^Fds, Ww, Ww, Ww, Hh, Hh, Gg, Gg, Re^Gvs, Gg^Vh, Hh, Gg, Gg, Gg, Gg, Gg, Gg^Vh, Ce, Re^Gvs, Re^Gvs, Re^Gvs, Ce, Ce, Gg, Gg
Gg, Gg, Gg, Re^Gvs, Re^Gvs, Re^Gvs, Re^Gvs, Gg, Hh, Gs^Fds, Gs^Fds, Gs^Fds, Gs^Fds, Gg, Gg, Gg, Gg, Re^Gvs, Re^Gvs, Re^Gvs, Hh, Gg, Gg, Gg, Gg, Re^Gvs, Re^Gvs, Re^Gvs, Re^Gvs, Gs^Fds, Re^Gvs, Gg, Gg, Gg, Gg
Gs^Fds, Gg, Gg, Gg, Gg, Gg, Gs^Fds, Gg, Hh, Gs^Fds, Gs^Fds, Gs^Fds, Gg, Gs^Fds, Gs^Fds, Gs^Fds, Gg, Gg, Re^Gvs, Re^Gvs, Re^Gvs, Gg, Gg, Gg, Gg, Re^Gvs, Re^Gvs, Re^Gvs, Re^Gvs, Re^Gvs, Re^Gvs, Re^Gvs, Gg, Gg, Gg
Gs^Fds, Gs^Fds, Gs^Fds, Hh, Gg, Hh, Hh, Gg, Gs^Fds, Gs^Fds, Gg, Gg, Gg, Hh, Hh, Gg, Hh, Hh, Re^Gvs, Gg, Gg, Gg, Gg, Gg, Gg, Gs^Fds, Hh, Gg, Gg, Gg, Gg, Re^Gvs, Gg, Gg, Gg
Gs^Fds, Gs^Fds, Gg, Gg, Gg, Gg, Gs^Fds, Gg, Gg, Gg, Ch, Gg, Gs^Fds, Gs^Fds, Gg, Ch, Gg, Gg, Gg, Gg, Gg, Gg, Gg, Gg, Gg, Gs^Fds, Gs^Fds, Gg, Gg, Gg, Gg, Gg, Gg, Gg, Gg
Hh, Hh, Gg, Hh, Gs^Fds, Gg, Gg, Gs^Fds, Gg, Gg, Gg, Rr, Gg, Gs^Fds, Rr, Rr, Ch, Gg, Gg, Gg, Gg, Gs^Fds, Ch, Gg, Gg, Gg, Gg, Gg, Gg, Gg, Gg, Ch, Ch, Gg, Gg
Hh, Gg, Gg, Hh, Hh, Ch, Rr, Gg, Gg, Gg, Rr, Rr, Rr, Rp^Vhc, Gg, Ch, Ch, Ch, Gg, Gg, Hh, Gs^Fds, Gs^Fds, Gg, Gg, Gg, Hh, Hh, Hh, Gg, Gg, Gg, Ch, Gg, Gg
Gg, Gg, Gg, Gs^Fds, Hh, Hh, Gg, Rr, Rr, Rr, Gg, Gg, Gg, Rr, Rr, Gg, Gg, Rr, Gg, Gg, Gg, Gs^Fds, Gg, Gg, Gg, Gg, Gg, Gs^Fds, Gs^Fds, Gg, Gg, Gg, Ch, Gg, Gg
Gg, Gg, Gg, Gg, Gg, Gg, Gg, Gg, Rr, Gg, Gs^Fds, Gg, Rr, Rr, Gg, Rr, Rr, Rr, Rr, Gg, Gg, Gg, Gg, Gg, Gg, Gg, Gg, Gg, Rr, Gg, Rr, Rr, Rr, Gg, Rr
Rr, Gg, Gg, Gg, Ch, Gg, Rp^Vhc, Rr, Gg, Gg, Gg, Gg, Rr, Rp^Vhc, Gg, Gg, Gg, Gg, Gg, Rr, Rr, Gg, Rr, Rp^Vhc, Rr, Gg, Rr, Rr, Gg, Rr, Gg, Rp^Vhc, Ch, Rr, Gg
Gg, Rr, Rr, Rr, Rr, Gg, Rr, Rr, Gg, Gg, Gg, Gg, Rr, Gg, Gg, Gg, Ch, Gg, Gg, Gg, Rr, Rr, Gg, Rr, Gg, Rr, Gg, Gg, Gs^Fds, Gg, Ch, Ch, Gg, Rr, Gg
Gg, Gg, Gg, Ch, Ch, Rr, Gg, Rr, Rr, Rr, Rr, Rr, Gg, Rr, Rr, Ch, 3 Kh, Ch, Rr, Rr, Gg, Rr, Rr, Gg, Ww, Gg, Gg, Gs^Fds, Gs^Fds, Gg, Ch, Gg, Rr, Rr, Gg
Gg, Gg, Ch, Ch, Gg, Gg, Gg, Gg, Gg, Gg, Rp^Vhc, Rr, Gg, Gg, Gg, Ch, Ch, Ch, Gg, Gg, Gg, Gg, Ww, Ww, Ww, Ww, Gg, Gg, Gg, Gg, Ch, Rr, Gg, Gg, Hh
Gg, Gg, Ch, Gg, Gg, Gg, Gs^Fds, Gg, Gg, Gg, Gg, Rr, Gg, Gg, Hh, Gg, Gg, Rr, Ch, Gg, Gg, Hh, Gs^Fds, Ww, Gs^Fds, Ww, Gg, Ch, Ch, Ch, Gg, Rr, Hh, Hh, Hh
Gg, Gg, Gg, Ch, Gg, Gs^Fds, Gs^Fds, Hh, Hh, Hh, Gg, Rr, Gg, Gg, Gg, Gg, Gg, Rp^Vhc, Gg, Ch, Hh, Hh, Gg, Gg, Gs^Fds, Gs^Fds, Gs^Fds, Gg, Gg, Gg, Rr, Gg^Vh, Hh, Hh, Hh
Gg, Gg, Ch, Ch, Ch, Gg, Rr, Gg, Gg, Gg, Rr, Rr, Rr, Gg, Rp^Vhc, Gg, Rr, Rr, Gg, Ch, Gs^Fds, Hh, Gg, Gs^Fds, Gs^Fds, Gs^Fds, Gg, Gg, Rr, Rr, Gg, Gg, Hh, Hh, Hh
Gg, Gg, Ch, Ch, Ch, Rr, Ch, Rr, Rr, Rr, Gg, Gg, Gg, Rr, Rr, Rr, Gg, Gg, Ww, Mm, Hh, Mm, Gg, Gs^Fds, Gs^Fds, Gg, Gg, Rr, Gg, Gg, Gs^Fds, Gs^Fds, Gg, Gg, Gg
Gg, Gg, Gg, Ch, Gg, Ch, Ch, Gg, Rp^Vhc, Rr, Rr, Gg, Gg, Gg, Gg^Vh, Gg, Gg, Gg, Ww, Ww, Mm, Hh, Gg, Gs^Fds, Gs^Fds, Gs^Fds, Gs^Fds, Gg^Vh, Gs^Fds, Gs^Fds, Gs^Fds, Gs^Fds, Gs^Fds, Gg^Vh, Gg
Gg, Gg, Gg, Gg, Re, Gg, Ch, Gg, Gg, Gg, Rr, Gg, Gg, Gg, Ch, Ch, Ch, Ch, Hh, Mm, Hh, Gs^Fds, Gs^Fds, Gg, Gs^Fds, Gs^Fds, Gs^Fds, Gs^Fds, Gs^Fds, Gs^Fds, Gg, Gs^Fds, Gs^Fds, Gg, Gg
Gg, Gg, Re, Re, Re, Re, Re, Ch, Ch, Ch, Rr, Ch, Ch, Ch, Gg, Gg, Gg, Gg, Gg, Gs^Fds, Hh, Gs^Fds, Gs^Fds, Gs^Fds, Gs^Fds, Gs^Fds, Gg, Gs^Fds, Gg^Vh, Rd, Gs^Fms, Gg, Gg, Gg, Gs^Fms
Gg, Gg, Re, Re, Re, Re, Re, Re, Gg, Gg, Rr, Gg, Gg, Gg, Gg, Gg, Gg, Gg, Gg, Gg, Gg, Gs^Fds, Gg, Gg, Gg, Rd, Rd, Rd, Rd, Rd, Gs^Fms, Gs^Fms, Gs^Fms, Gs^Fms, Gs^Fms
Gg, Gg, Gg, Re, Re, Re, Rr, Gg, Rr, Rr, Gg, Gg, Gg, Gg, Gg, Gg, Gg, Gs^Fms, Gs^Fms, Gs^Fms, Gg, Gs^Fds, Gg, Gs^Fms, Gs^Fms, Gg, Rd, Gg, Gg, Gg, Gs^Fms, Gs^Fms, Gs^Fms, Gs^Fms, Gs^Fp
Gg, Gg, Gg, Gg, Gg, Gg, Gg, Rr, Gg, Gg, Gg, Gg, Gg, Gg, Gg, Gg, Gs^Fms, Gs^Fms, Gs^Fms, Gs^Fms, Gs^Fms, Gg, Gs^Fms, Gs^Fms, Gs^Fms, Gs^Fms, Rd, 5 Gg, Gs^Fms, Gs^Fms, Gs^Fms, Gs^Fms, Gs^Fms, Gs^Fms, Gs^Fp
Gg, Gg, Gg, Gg, Gg, Gg, Gg, Gg, Gg, Gg, Gg, Gg, Gg, Gg, Gg, Gg, Gs^Fms, Gs^Fms, Gs^Fp, Gs^Fp, Gs^Fp, Gs^Fms, Gs^Fp, Gs^Fms, Gs^Fp, Gs^Fp, Rd, Gg, Gs^Fp, Gs^Fp, Gs^Fp, Gs^Fp, Gs^Fp, Gs^Fp, Gg
