Re, Re, Rr, Gs^Fds, Gs^Fds, Gs^Fds, Gs^Fms, Gs^Fms, Gs^Fms, Gs^Fms, Gs^Fms, Gs^Fp, Gs^Fp, Gs^Fp, Gs^Fp, Gs^Fp, Gs^Fp, Gs^Fp, Gs^Fp, Ww, Gg, Gg, Gs, Gd^Fp, Gd^Fp, Gd^Fp, Gd^Fp, Gd^Fp, Gd^Fp, Gs^Fp, Hh, Mm, Mm, Hh, Mm, Hh, Mm, Gs^Fp, Gs^Fp, Gs^Fp, Gs^Fp, Gs^Fp
Re, Re, 1 Rr, Gs^Fds, Rr, Gs^Fds, Gs^Fms, Gs^Fms, Gs^Fp, Gs^Fmw, Gs^Fms, Gs^Fds, Gs^Fp, Gs^Fp, Gs^Fms, Gs^Fp, Gs^Fp, Gs^Fp, Gs^Fp, Ww, Gg, Gs, Gd, Gd^Fp, Gd^Fp, Gd^Fmw, Gs^Fds, Gd^Fp, Gs^Fp, Gs^Fp, Hh, Mm, Mm, Hh, Mm, Hh, Mm, Gs^Fp, Gs^Fp, Gs^Fp, Gs^Fp, Gs^Fp
Gs^Fds, Gs^Fds, Gs^Fms, Rr, Gs^Fms, Rr, Gs^Fms, Gs^Fds, Gs^Fds, Gs^Fds, Gs^Fds, Gs^Fms, Gs^Fms, Gs^Fp, Gs^Fms, Gs^Fp, Gs^Vh, Gs^Fp, Ww, Ww, Gs^Fp, Gs, Gd^Fp, Gd^Fp, Gs^Fp, Gs^Fp, Mm, Mm, Hh, Gs^Fp, Gs^Fp, Mm, Hh, Qxe, Qxe, Mm, Mm, Mm, Hh, Gs^Fds, Gs^Fp, Gs^Fp
Gs^Fms, Gs^Fds, Gs^Fms, Gs^Fds, Gs^Fms, Rr, 2 Rr, Gs^Fds, Ce, Ce, Gs, Gs^Vh, Gs, Gs^Fp, Gs^Fp, Gs^Fp, Gs^Fp, Wo, Ww, Gs^Fp, Gs^Fp, Gs^Fp, Mm, Gs^Fp, Mm, Hh, Mm, Mm, Mm, Mm, Mm, Gs^Fp, Mm^Xm, Mm, Gs^Fp, Mm, Qxe, Mm, Hh, Gs^Fp, Gs^Fp, Gs^Fp
Gg, Gg, Gs^Fms, Gs^Fmw, Gs^Fds, Gs^Fms, Ce, Ke, Rr, Gs, Gs^Vl, Gs, Gs, Gs, Gs^Fp, Gs^Fds, Gs^Fp, Wo, Ww, Gs^Fp, Gs^Fp, Gs^Fp, Gs^Fp, Mm, Qxe, Mm, Qxe, Mm, Mm^Xm, Mm^Xm, Mm^Xm, Mm^Xm, Xu, Mm^Xm, Mm^Xm, Mm, Qxe, Mm, Hh, Gs^Fp, Gs^Fp, Gs^Fp
Gg, Gg, Gs^Fms, Gs^Fp, Gs^Fds, Ce, Gs^Vh, Gs, Gs, Rr, Rr, Gs, Gs^Fp, Gs^Vh, Ce, Gs^Fp, Gs^Fp, Ww, Gs^Fp, Gs^Fms, Gs^Fms, Gs^Fp, Gs^Fmw, Hh, Mm, Qxe, Qxe, Qxe, Xu, Xu, Xu, Xu, Ql, Xu, Xu, Mm^Xm, Mm, Hhd, Gs^Fp, Gs^Fmw, Gs^Fp, Gs^Fp
Gg, Gg, Gs^Fms, Gs^Fp, Gs^Fp, Gs^Fms, Gs, Gs, Gs, Gs, Gs^Fp, Rr, 3 Ke, Ce, Gs^Fp, Gs^Fp, Ww, Ww, Gs^Vh, Gg, Gg, Gs^Fp, Gg, Gs^Fp, Hh, Hh, Qxe, Xu, Uu^Uf, Uu^Vu, Uu, Uu, Uu, Uu, Mm, Mm^Xm, Qxe, Mm, Hh, Gs^Fp, Gs^Fds, Gs^Fp
Gs^Fms, Gs^Fms, Gs^Fms, Gs^Fp, Gs^Fp, Gs^Fp, Gs^Vh, Gs^Fp, Gs, Gs^Fp, Ce, Ce, Rr, Rr, Ww^Bw\, Ww, Ww, Gs^Fp, Gs^Fp, Gg, Gg, Gs^Fp, Gs^Fp, Gs^Fp, Hh, Mm, Mm^Xm, Xu, Uu, Uu, Ce, Ce, 4 Kud, Ce, Xu, Mm, Gs^Fp, Qxe, Hh, Gs^Fp, Gs^Fp, Gs^Fp
Gs^Fms, Gs^Fms, Gs^Fmw, Gs^Fp, Gs^Fp, Gs^Fp, Gs^Fp, Gs^Vh, Gs^Fp, Gs^Fds, Ww, Ww, Ww^Bw|, Ww, Gs^Fp, Re, Re, Ww, Ww, Gs^Fp, Ds, Ds, Ds, Hh, Mm, Mm, Hhd, Uu, Xu, Uu, Uh, Cud, Uu, Cud, Xu, Mm^Xm, Hh, Hh, Gs^Fp, Gs^Fp, Gs^Fp, Gs^Fp
Gs^Fp, Gs^Fp, Gs^Fp, Gs^Fms, Gs^Fp, Gs^Fp, Ww, Gs^Fp, Ww, Ww, Gs^Fms, Ww, Re, Gs^Fp, Gs^Fp, Gg, Gg^Vh, Re, Re, Ww, Ww, Ds, Ds, Re^Fp, Re^Fp, Hhd, Hhd, Qxe, Mm^Xm, Xu, Xu, Uu, Uu, Xu, Mm^Xm, Mm^Xm, Gd^Fp, Mm, Gs^Fp, Gs^Fp, Re, Re
Gs^Fp, Gs^Fp, Gs^Fms, Gs^Fp, Ww, Ww, Gs^Fds, Ww, Gs^Fds, Gs^Fms, Re, Re, Gg, Gg, Gg, Gg, Gs^Fp, Gs^Fp, Re, Gs^Fp, Gs^Fp, Ww, Ds, Re^Fp, Re^Fp, Re, Qxe, Qxe, Mm, Mm^Xm, Hhd, Re, Re^Fp, Mm^Xm, Re^Fmw, Mm, Mm, Gs^Fp, Re, Gs^Fp, Re, Re
Gs^Fp, Gs^Fp, Ww, Ww, Gs^Fds, Gs^Fds, Gs^Fds, Gs^Fds, Re, Gs^Fds, Gs^Fms, Gs^Fms, Gs^Fms, Gs^Fp, Hh, Gs^Fp, Gs^Fp, Re, Gs^Fp, Gs^Fp, Gs^Fp, Ww, Ww, Ds, Re^Fp, Qxe, Qxe, Gll^Fp, Gll^Fp, Mm, Mm, Re^Fmw, Re, Re^Fp, Mm, Mm, Re, Re, Gll^Fp, Re, Gll^Fp, Gll^Fp
Ww, Ww, Ww, Gs^Fds, Gg, Gs^Vl, Gs^Fds, Gs^Fds, Re, Gs^Fms, Gs^Fms, Gs^Fms, Gs^Fp, Gg^Vh, Hh, Hh, Hh, Re, Hh, Hh, Hh, Ds, Ds, Ww, Re^Fp, Gll^Fp, Gll^Fp, Gll^Fp, Gll^Fp, Gll^Fp, Gll^Fp, Re^Fp, Gll^Fp, Re, Re, Re, Hh, Hh, Gll^Fp, Gll^Fp, Gll^Fp, Gll^Fp
Gs^Fds, Gs^Fds, Gs^Fds, Gs^Fds, Gs^Fds, Gg, Gs^Fds, Gs^Fds, Re, Gs^Fms, Gs^Fms, Gs^Fp, Gs^Fp, Gs^Fp, Gs^Fmw, Hh, Hh, Re, Re, Hh, Gs^Fp, Gs^Fp, Ww, Ww, Re^Fp, Re^Fp, Re, Gll^Fp, Gll^Fp, Gll^Fp, Gll^Fp, Gll^Fp, Re, Re, Gll^Fp, Hh, Gll^Fmw, Gll^Fp, Gll^Fp, Gll^Fp, Gll^Fp, Gll^Fp
Gs^Fds, Gs^Fmw, Re, Gs^Fds, Gs^Fds, Gs^Fms, Gg, Gs^Fmw, Re, Re, Re, Gs^Fp, Gs^Fp, Gs^Fp, Gs^Fp, Gs^Fp, Gs^Fmw, Hh, Re, Gs^Fp, Gs^Fp, Gs^Fp, Gs^Fp, Ss, Re, Re, Gll^Fp, Re, Gll^Fp, Re, Gll^Fp, Re, Gll^Fp, Gll^Fp, Gll^Fp, Gll^Fp, Gll^Fp, Gll^Fp, Gll^Fp, Gll^Fp, Gll^Fp, Gll^Fp
Re, Re, Gs^Fds, Re, Re, Gg, Re, Gs^Fms, Gs^Fms, Gs^Fms, Gs^Fms, Re, Re, Gs^Fp, Gs^Fms, Gs^Fp, Gs^Fp, Gs^Fp, Re, Gs^Fms, Gs^Fp, Gs^Fmw, Re, Ww^Bw/, Ss, Gll^Fp, Hh, Gll^Fp, Gll^Fp, Re, Re, Gll^Fp, Gll^Fp, Gll^Fp, Gll^Fp, Gll^Fp, Gg, Gs, Gs, Gs^Vl, Gll^Fp, Gll^Fp
Gs^Fds, Gs^Fds, Gs^Vh, Gs^Fds, Gs^Fds, Re, Gs^Fds, Gs^Fds, Gs^Fms, Gs^Fp, Gs^Fp, Gs^Fp, Re, Gs^Fp, Gs^Fp, Gs^Fp, Gs^Fp, Gs^Fp, Gs^Fp, Re, Re, Re, Gs^Fp, Ss, Ss, Hh, Hh, Gll^Fp, Gs^Vl, Gll^Fp, Gll^Fp, Re, Re, Gll^Fmw, Gll^Fp, Gll^Fp, Gg, Gg, Gg, Gs, Gll^Fp, Gll^Fp
Gs^Fds, Gs^Fds, Gs^Fds, Gs^Fds, Gs^Fds, Gs^Fds, Rd, Re, Re, Gs^Fms, Gs^Fp, Re, Gs^Fp, Gs^Fms, Gs^Fp, Gs^Fmw, Gs^Fp, Gs^Fms, Gs^Fp, Gs^Fp, Gs^Fp, Re, Gs^Fp, Gs^Fp, Gs^Fp, Ww, Gll^Fp, Gs, Gll^Fp, Gll^Fp, Re, Re, Gg, Gll^Fp, Re, Gll^Fp, Gg, Gg, Gll^Fmw, Gll^Fp, Gll^Fp, Gll^Fp
Gs^Fds, Gs^Fmw, Rd, Rd, Rd^Fds, Rd, Rd^Fp, Rd^Fp, Gll^Fds, Re, Re, Re, Gs^Fp, Gs^Fp, Gs^Fms, Gs^Fmw, Gs^Fp, Gs^Fp, Gs^Fp, Hh, Hh, Gs^Fp, Hh, Hh, Gs^Fp, Ww, Gll^Fp, Gll^Fp, Gll^Fp, Gll^Fp, Re, Gg, Gg, Gll^Fp, Gll^Fp, Re, Re, Gll^Fp, Gll^Fp, Gll^Fp, Re, Re
Gs^Fds, Gs^Fds, Rd, Gs^Fms, Gs^Fms, Rd, Rd, Rd^Fdw, Gll, Gll^Fp, Gll^Fms, Re, Re, Gs^Fms, Gs^Fp, Gs^Fp, Re, Gs^Fp, Gs^Fp, Gs^Vh, Gs^Vh, Hh, Hh, Gs^Fp, Gs^Fp, Ww, Gll^Fp, Gll^Fp, Gll^Fp, Gll^Fp, Gs^Fmw, Re, Gg, Gll^Fp, Gll^Fp, Gll^Fp, Gll^Fp, Re, Re, Re, Gll^Fp, Gll^Fp
Rd, Rd, Gs^Fms, Gs^Fdw, Mm, Hhd, Rd, Rd^Fp, Hhd, Hhd, Ss, Re^Fdw, Gll^Fp, Re, Re, Re, Gs^Fp, Gs^Fp, Gs^Fp, Gs^Fp, Gs^Fms, Gs^Fp, Gs^Fp, Gs^Fp, Ww, Ww, Gll^Fp, Gll^Fp, Hh, Gll^Fp, Gll^Fp, Re, Gg, Gll^Fp, Gll^Fmw, Hh, Gll^Fp, Gll^Fp, Gll^Fp, Gll^Fp, Gll^Fp, Gll^Fp
Gs^Fms, Gs^Fms, Gs^Fms, Gs^Fms, Mm, Mm, Rd^Fp, Hhd, Rd, Mm, Ss, Ss, Re^Fdw, Gll^Fp, Re, Gs^Fmw, Gs^Fms, Gs^Fmw, Gs^Fp, Gs^Fp, Gs^Fp, Gs^Fp, Ww, Ww, Gg, Gs^Fp, Gll^Fp, Gll^Fp, Gs^Vl, Hh, Gll^Fp, Re, Re, Gg, Gg, Gll^Fp, Gll^Fms, Gll^Fmw, Hh, Hh, Gll^Fmw, Gll^Fp
Gs^Fp, Gs^Fdw, Hhd, Mm, Hhd, Rd, Ds, Rd, Ce, Ss, Re, Hhd, Mm, Re^Fp, Gs^Fp, Re, Re^Fp, Gs^Fp, Gs^Fdw, Gs^Fp, Gs^Fp, Gs^Fms, Ww, Gs^Fp, Gg, Gg, Gg, Gg, Gg, Gg, Gg, Gg, Re, Re, Re, Gg, Gll^Fp, Gll^Fp, Gll^Fp, Hh, Gll^Fp, Gll^Fp
Gs^Fms, Gs^Fms, Mm, Gs, Ss, Ss, Ds, Ce, 5 Ke, Ce, Re^Uf, Mm, Mm, Gs^Fms, Hh, Hh, Re, Gs^Fp, Gs^Fp, Wo, Gs^Fp, Gs^Fp, Ww, Gs^Fp, Gs^Vh, Gg, Gg, Gg, Hh, Gll^Fp, Re, Re, Gll^Fp, Gll^Fp, Gll^Fp, Re, Re^Fp, Re^Fmw, Gll^Fmw, Gll^Fp, Gll^Fds, Gll^Fp
Gs^Fms, Gs^Fms, Mm, Gs, Ss, Re^Uf, Re^Uf, Ce, Ce, Ce, Re^Uf, Hhd, Mm, Gs^Fms, Gs^Fms, Hh, Re, Gs^Fms, Gs^Fmw, Gs^Fms, Gs^Fms, Gs^Fms, Ww, Gs^Fp, Gs^Fp, Gs^Fp, Gll^Fmw, Hh, Gll^Fmw, Gll^Fp, Re^Fp, Gll^Fp, Gll^Fdw, Gll^Fmw, Gs^Fmw, Gll^Fdw, Gll^Fmw, Re, Re, Gll^Fp, Gll^Fmw, Gll^Fp
Gs^Fms, Gs^Fdw, Gs^Fds, Mm, Mm, Mm, Gll^Fp, Re, Ds, Ss, Ss, Ss, Mm, Mm, Gs^Fms, Gs^Fdw, Re, Gs^Fms, Gs^Fms, Gs^Fmw, Gs^Fms, Gs^Fms, Gs^Fms, Ww, Ww, Ds, Ds, Gll^Fp, Gll^Fmw, Re, Gll^Fmw, Gll^Fms, Gs, Gll^Fp, Gll^Fmw, Gll^Fp, Gll^Fp, Gll^Fp, Re, Gll^Fp, Gll^Fdw, Gll^Fp
Gs^Fms, Gs^Fds, Gs^Fds, Gs^Fds, Hh, Mm, Mm, Gll^Fdw, Mm, Ds, Mm, Mm, Mm, Gs^Fms, Re, Re^Fds, Gs^Fds, Re, Re, Re, Re, Gs^Fmw, Gs^Fms, Ds, Ds, Ww, Ds, Gll^Fp, Re^Fp, Re, Gs, Gs, Gs, Gs, Gll^Fp, Gll^Fp, Mm, Gs^Fmw, Gs^Fp, Re, Re, Re
Gs^Fms, Gs^Fds, Gs^Fds, Gs^Fdw, Gs^Fds, Hh, Gs, Hh, Gs, Ds, Mm, Mm, Gs^Fds, Gs^Fdw, Re, Gs^Fms, Gs^Fmw, Gs^Fds, Gs^Fds, Gs^Fmw, Gs^Fds, Re^Fds, Re, Gs^Fmw, Gs^Fms, Ww, Ds, Gll^Fmw, Re, Gd, Gs, Gs, Gd^Fp, Gd^Fdw, Mm, Mm, Gs, Gs^Fdw, Gs, Gd^Fp, Gd^Fp, Gd^Fp
Gs^Fms, Gs^Fms, Gg, Gs^Fds, Gg, Gg, Gs, Hh, Hh, Hh, Gs^Fms, Gs^Fms, Gs^Fms, Re, Gs^Fms, Gs^Fds, Gs^Fds, Hh, Mm, Hh, Mm, Gs^Fds, Gs^Fds, Re, Re^Fds, Ww, Ds, Gll^Fp, Re, Gs, Gll^Fmw, Gll^Fp, Mm, Mm, Gs, Mm, Gs, Gd, Gd, Mm, Gd^Fmw, Gd^Fp
Gg, Gg, Gg, Gs^Fds, Gg, Gg, Gg, Gs, Gs^Fms, Gs^Fp, Gs^Fms, Gs^Fms, Re, Re, Gs^Fds, Hh, Mm, Mm, Mm, Mm, Mm, Mm, Hh, Gs^Fds, Gs^Fds, Ww, Ww, Gs^Fp, Gll^Fp, Gll^Fp, Gs^Fmw, Mm, Mm, Gs, Gd, Gd, Gd, Gd^Fdw, Mm, Mm, Gd^Fmw, Gd^Fp
Gs^Fms, Gs^Fms, Gs^Fms, Gg, Gs^Fms, Gg, Gs^Fp, Gs^Fp, Gs^Fmw, Gs^Fds, Re, Gs^Fds, Gs^Fms, Gs^Fds, Mm, Mm, Mm, Mm^Xm, Mm^Xm, Mm^Xm, Mm^Xm, Mm, Mm, Hh, Gs^Fds, Ds, Ww, Gs^Fp, Ss^Vhs, Gs^Fmw, Gs^Fdw, Hh, Mm, Mm, Mm, Gd^Fmw, Re^Fdw, Re, Rb^Uf, Mm, Mm, Mm
Gs^Fp, Gs^Fms, Gs^Fp, Gs^Fms, Gg, Gg, Gs^Fp, Gs^Fms, Re, Re, Gs^Fms, Gs^Fds, Gs^Fds, Gs^Fds, Gs^Fds, Hh, Mm, Mm, Mm, Mm^Xm, Mm, Mm, Mm, Mm, Gs^Fds, Ds, Ww, Ss, Ss, Ss, Ss, Gs^Fdw, Mm, Gs^Fdw, Mm, Re, Mm, Rb, Rb^Uf, Mm, Mm, Mm
Gs^Fp, Gs^Fp, Gs^Fp, Gg, Gs^Fp, Gg, Gs^Fp, Re, Gs^Fms, Re, Gs^Fms, Gs^Fds, Gs^Fmw, Gs^Fds, Gs^Fds, Mm, Hh, Mm, Mm, Mm, Mm, Hh, Hh, Hh, Gs^Fds, Gs^Fms, Ww, Gs^Fdw, Ss, Mm, Hh, Hh, Mm, Mm^Xm, Mm, Mm, Hhd, Hhd, Hhd, Mm, Hh, Hh
Gs^Fp, Gs^Fp, Gs^Fp, Gs^Fmw, Gs^Fp, Gs^Fp, Re, Re, Gs^Fds, Re, Re, Gs^Fds, Gs^Vl, Gs^Fds, Gs^Fms, Gg, Gg, Gg, Mm, Mm, Mm, Mm, Gs^Fds, Gs^Fdw, Gs^Fds, Gs^Fmw, Ww, Gs^Fdw, Hh^Fdw, Mm, Mm, Hhd^Fdw, Mm, Mm^Xm, Hhd, Mm, Mm^Xm, Mm, Mm, Hhd, Hhd, Hhd
Re, Re, Re, Gs^Fp, Re, Gs^Fp, Gs^Fms, Gs^Fms, Gs^Fp, Gs^Fms, Re, Gs^Fds, Gs^Fds, Gs^Fds, Gs^Fds, Gg, Gs^Fms, Gs^Fdw, Gs^Fds, Mm, Gs^Fds, Gs^Fdw, Ww, Gs^Fms, Ww, Ww, Ss, Gs^Fdw, Gs^Fdw, Hh^Fdw, Mm, Gd^Fdw, Hhd^Fdw, Hhd, Qxe, Mm, Cud, Uu^Vu, Rb^Uf, Mm, Mm^Xm, Mm^Xm
Gs^Fp, Gs^Fp, Hh, Re, Gs^Fp, Gs^Fp, Mm, Gs^Fms, Gs^Fp, Gs^Fms, Gs^Fds, Re, Re, Gs^Fms, Gs^Fds, Gs^Fms, Gs^Vh, Gs^Fds, Ss, Gs^Fds, Ww, Ww, Ss, Ww, Gs^Fdw, Gs^Fp, Ss, Ss, Ss^Vhs, Gs^Fdw, Gd^Fdw, Hhd^Fdw, Qxe, Rb^Uf, Qxe, Cud, 6 Kud, Cud, Mm^Xm, Mm^Xm, Mm^Xm, Mm^Xm
Gs^Fp, Gs^Fp, Gs^Vh, Re, Hh, Hh, Hh, Mm, Mm, Gs^Fp, Gs^Fp, Gs^Fdw, Gs^Fms, Re, Re, Gs^Fds, Gs^Fds, Gs^Fds, Ww, Ww, Ss, Gs^Fp, Gs^Fp, Gs^Fp, Gs^Fp, Ss^Vhs, Gs^Fmw, Gs^Fdw, Gg, Gg, Gd^Fdw, Hhd^Fdw, Mm, Qxe, Rb^Uf, Cud, Cud, Cud, Mm, Mm^Xm, Mm^Xm, Mm^Xm
Gs^Fp, Gs^Fp, Re, Re, Re, Gs^Fp, Gs^Vh, Hh, Hh, Mm, Mm, Gs^Fms, Gs^Fms, Gs^Fds, Re, Gs^Fms, Gs^Fds, Ww, Gs^Fp, Ss, Ss^Vhs, Gs^Fp, Gs^Fp, Gs^Fmw, Gg, Gs^Fmw, Gg, Gd^Fdw, Gd^Fdw, Gg, Gd^Fdw, Mm, Hhd, Qxe, Hhd, Hhd, Mm, Mm, Mm, Mm, Rb^Uf, Rb^Uf
Gs^Fp, Gs^Fp, Gs^Fp, Gg, Re, Re, Re, Gs^Fp, Hh, Mm, Mm, Mm, Gs^Fms, Gs^Fms, Gs^Fms, Re, Ww^Bw\, Ww, Gs^Fp, Gs^Fp, Gs^Fp, Gs^Fp, Gs^Fp, Gg, Hh, Gg, Gg, Gs^Fmw, Gd^Fdw, Mm, Hhd^Fdw, Rb, Rb, Mm, Mm, Mm^Xm, Rb^Uf, Qxe, Qxe, Qxe, Rb^Uf, Rb^Uf
Gs^Fp, Gs^Fp, Gs^Fp, Gs^Vl, Gs^Fp, Gg, Gg, Re, Re, Mm, Mm, Gs^Fp, Ww, Ww, Ww, Ww, Gs^Fp, Re, Re, Gs^Fp, Gs^Fp, Gs^Fp, Gg, Gg, Gg, Hh, Gg, Gg, Gd^Fmw, Rb^Uf, Rb^Uf, Hhd, Mm, Hhd, Mm, Hhd, Rb^Uf, Rb^Uf, Mm, Mm, Mm, Mm
Gs^Fp, Gs^Fp, Gs^Fp, Gs^Fp, Gs^Fp, Gg, Gs^Fp, Gg, Re, Gs^Vh, Hh, Gs^Fp, Ww, Gs^Fp, Gs^Fp, Gs^Fp, Gs^Fp, Gs^Vh, Gs^Fp, Re, Gs^Fp, Gg, Gs^Fp, Gs^Fp, Gs^Fmw, Gg, Gs^Fp, Gs^Fdw, Gs^Fp, Gd^Fmw, Gd^Fdw, Mm, Mm, Mm, Mm, Mm, Mm, Mm, Mm, Mm, Mm, Mm
Gs^Fp, Gs^Fp, Gs^Fp, Gs^Fp, Gs^Fp, Gg, Gs^Fp, Gg, Re, Gg, Hh, Gs^Fp, Ww, Gs^Fp, Gs^Fp, Gs^Fp, Gs^Fp, Gs, Gs^Fp, Re, Gs^Fp, Gg, Gs^Fp, Gs^Fp, Gs^Fp, Gg, Gs^Fp, Gs^Fmw, Gs^Fp, Gs^Fp, Gd^Fp, Mm, Mm, Mm, Mm, Mm, Mm, Mm, Mm, Mm, Mm, Mm
