Re, Re, Rr, Gs^Fds, Gs^Fds, Gs^Fds, Gs^Fms, Gs^Fms, Gs^Fms, Gs^Fms, Gs^Fms, Gs^Fp, Gs^Fp, Gs^Fp, Gs^Fp, Gs^Fp, Gll^Fp, Gll^Fp, Gll^Fp, Gll^Fp, Gll^Fp, Wwg, Wog, Wwg, Gll^Fmw, Gll^Fp, Hhd^Fp, Hhd^Fmw, Hhd^Fmw, Xue, Xue, Xue, Xue, Xue, Xue, Xue, Xue, Xue, Xue, Xue, Xue, Xue
Re, Re, 1 Rr, Gs^Fds, Rr, Gs^Fds, Gs^Fms, Gs^Fms, Gs^Fp, Gs^Fmw, Gs^Fms, Gs^Fds, Gs^Fp, Gs^Fp, Gs^Fms, Gs^Fp, Gll^Fp, Gll^Fp, Gll^Fp, Gll^Fp, Wog, Wwg, Wog, Wwg, Gll^Fp, Hhd^Fdw, Hhd, Hhd, Hhd^Fmw, Xue, Xue, Xue, Xue, Xue, Xue, Xue, Xue, Xue, Xue, Xue, Xue, Xue
Gs^Fds, Gs^Fds, Gs^Fms, Rr, Gs^Fms, Rr, Gs^Fms, Gs^Fds, Gs^Fds, Gs^Fds, Gs^Fds, Gs^Fms, Gs^Fms, Gs^Fp, Gs^Fms, Gs^Fp, Gll^Fp, Gll^Fp, Wwg, Gll^Fp, Wog, Wog, Wwg, Gll^Fmw, Gll^Fmw, Hhd^Fp, Hhd, Hhd^Fp, Xue, Xue, Uhe, Uhe^Vu, Uue, Cer, 4 Ker, Cer, Uue^Tf, Xue, Xue, Xue, Xue, Xue
Gs^Fms, Gs^Fds, Gs^Fms, Gs^Fds, Gs^Fms, Rr, 2 Rr, Gs^Fds, Ce, Ce, Gs, Gs^Vh, Gs, Gs^Fp, Gs^Fp, Gs^Fp, Gll^Fp, Gll^Fp, Gll^Fp, Wwg, Wog, Wog, Wwg, Gll^Fp, Gll^Fp, Gll^Fdw, Hhd^Fmw, Hhd^Fmw, Xue, Xue, Uhe^Vu, Rb, Rb^Edb, Cer, Cer, Cer, Uue^Tf, Xue, Xue, Xue, Xue, Xue
Gg, Gg, Gs^Fms, Gs^Fmw, Gs^Fds, Gs^Fms, Ce, Ke, Rr, Gs, Gs^Vl, Gs, Gs, Gs, Gs^Fp, Gs^Fds, Gll^Fp, Gll^Fp, Wwg, Wog, Gll^Fmw, Gll^Fmw, Gll^Fmw, Hhd^Fmw, Hhd^Fmw, Hhd^Fmw, Gll^Fp, Xue, Uue, Uue, Xue, Xue^Edb, Rb^Edb, Rb^Edb, Rb^Edb, Rb, Uue^Edb, Xue, Uue^Vu, Xue, Xue, Xue
Gg, Gg, Gs^Fms, Gs^Fp, Gs^Fds, Ce, Gs^Vh, Gs, Gs, Rr, Rr, Gs, Gs^Fp, Gs^Vh, Ce, Gs^Fp, Gll^Fp, Wwg, Wwg, Gll^Fp, Gll^Vhs, Gll^Fmw, Gll^Fp, Hhd^Fmw, Hhd^Fmw, Hhd, Xue, Xue, Uue, Xue, Xue, Xue, Uhe, Uhe, Rb^Edb, Rb, Rb^Edb, Uue, Uue^Tf, Xue, Xue, Xue
Gg, Gg, Gs^Fms, Gs^Fp, Gs^Fp, Gs^Fms, Gs, Gs, Gs, Gs, Gs^Fp, Rr, 3 Ke, Ce, Gs^Fp, Gs^Fp, Wwg, Wwg, Wwg, Wwg, Gll^Fp, Gll^Fmw, Gll^Fp, Gll^Fmw, Gll^Fmw, Hhd^Fmw, Xue, Xue, Uue, Xue, Uue^Tf, Uhe, Uhe, Uue^Vu, Rb^Edb, Uue, Uue^Edb, Uue, Xue, Xue, Xue, Xue
Gs^Fms, Gs^Fms, Gs^Fms, Gs^Fp, Gs^Fp, Gs^Fp, Gs^Vh, Gs^Fp, Gs, Gs^Fp, Ce, Ce, Rr, Rr, Wwg^Bw\, Wwg, Gll^Fp, Wwg, Wwg, Gll^Fp, Wwg, Wwg, Wwg, Hhd^Fmw, Hhd^Fmw, Hhd^Fmw, Hhd, Xue, Xue, Uue, Rb^Edb, Uhe, Rb^Edb, Rb, Uhe, Uhe, Uue^Edb, Xue, Uue^Vu, Xue, Xue, Xue
Gs^Fms, Gs^Fms, Gs^Fmw, Gs^Fp, Gs^Fp, Gs^Fp, Gs^Fp, Gs^Vh, Gs^Fp, Gs^Fds, Wwg, Wwg, Wwg^Bw|, Wwg, Gll^Fmw, Gs, Gll^Fmw, Gll^Fmw, Gll^Fmw, Wwg, Gll^Fmw, Gll^Fp, Gll^Fmw, Wwg, Wwg, Hhd^Fp, Hhd^Fp, Xue, Xue, Rb^Edb, Rb, Uue^Edb, Uue, Uue, Uhe, Uhe, Uue^Tf, Uue, Uue, Uue, Xue, Xue
Gs^Fp, Gs^Fp, Gll^Fp, Gs^Fms, Gll^Fp, Gs^Fp, Gll^Fp, Gs^Fp, Gll^Fp, Wwg, Gll^Fp, Wwg, Re, Gll^Fmw, Gll^Fmw, Gs^Edb, Gs, Gll^Fmw, Gll^Fmw, Gll^Fmw, Gll^Fdw, Gll^Fp, Gll^Fp, Gll^Fp, Wwg, Hhd^Fp, Wwg, Hhd^Fp, Hhd^Fdw, Xue, Re, Rb, Xue, Uue^Vu, Uhe, Xue, Xue, Uhe, Xue, Uue^Vu, Xue, Xue
Gll^Fp, Gll^Fp, Gll^Fp, Gll^Fp, Gll^Fp, Gll^Fp, Gll^Fp, Gll^Fp, Gll^Fp, Wwg, Gll^Fp, Gll^Fmw, Re, Gll^Fp, Gll^Fmw, Gll^Fp, Gll^Fp, Re, Gll^Fdw, Gll^Fp, Gll^Fmw, Gll^Fmw, Gll^Fmw, Gll^Fmw, Gll^Fmw, Wwg, Gll^Fmw, Wwg, Wwg, Hhd^Fmw, Re, Re, Xue, Xue, Xue, Xue, Hhd^Fp, Xue, Hhd, Xue, Hhd^Fmw, Hhd^Ftr
Gll^Fp, Gll^Fp, Gll^Fp, Gll^Fp, Gll^Fp, Gll^Fp, Gll^Fp, Gll^Fp, Wwg, Wwg, Gll^Fmw, Gll^Fmw, Re, Gll^Fmw, Gll^Fmw, Gll^Vht, Gs, Re, Gs, Gll^Fmw, Gs^Em, Gll^Vhs, Gll^Fp, Gll^Fp, Gll^Fp, Gll^Fp, Gll^Fmw, Gll^Fp, Re, Wwf, Wwg, Hhd^Fp, Hhd^Fmw, Xue, Hhd, Hhd^Fp, Hhd^Fp, Gll^Fmw, Hhd^Fdw, Hhd, Hhd^Fp, Hhd^Ftr
Gll^Fp, Gll^Fp, Gll^Fp, Gll^Fp, Gll^Fp, Wwg, Gll^Fp, Wwg, Ss, Gll^Fp, Gll^Fp, Gll^Fmw, Gll^Fp, Re, Re, Gs, Gs, Gll^Fp, Gll^Fmw, Gs^Em, Gll^Fmw, Gs, Gs, Gll^Fp, Re, Gll^Fp, Re, Re, Gll^Fp, Wwg, Wog, Wwg, Hhd^Fp, Hhd^Fmw, Gll^Fmw, Hhd^Fp, Hhd^Fmw, Hhd, Gll^Fmw, Hhd^Fp, Gll^Fp, Hhd^Ftr
Gll^Fp, Gll^Fp, Gll^Fp, Gll^Vc, Gll^Fp, Wwg, Wwg, Wwg, Ss, Ss, Ss, Gll^Fp, Gll^Fmw, Gll^Fmw, Gs, Gll^Fmw, Gll^Fmw, Gd^Fetd, Gs^Edb, Gs^Edb, Gll^Fp, Gll^Fp, Gs^Em, Re, Gll^Fp, Re, Gll^Fmw, Gll^Fmw, Gll^Fmw, Wwg, Wog, Wwg, Hhd^Fp, Hhd^Fmw, Gll^Fmw, Hhd^Fp, Gll^Fmw, Hhd^Fmw, Gll^Fp, Gll^Fp, Hhd, Hhd^Ftr
Gll^Fp, Gll^Fp, Gll^Fp, Gll^Fp, Gll^Fp, Gll^Fp, Wwg, Wwg, Wwg, Ss, Ss, Gll^Fp, Gll^Fp, Gll^Vhs, Gll^Fp, Re, Gll^Fp, Gll^Fp, Gll^Fmw, Gll^Fmw, Gs, Gs, Gll^Fdw, Gs, Gs, Gll^Fmw, Gd^Fetd, Gll^Fmw, Gll^Fmw, Wwg, Wog, Wog, Wwg, Gll^Fmw, Gll^Fdw, Gll^Fmw, Gll^Fp, Gll^Fmw, Hhd^Fmw, Hhd, Hhd, Hhd^Ftr
Gll^Fp, Gll^Fp, Wwg, Wwg, Wwg, Wwg, Wwg, Wwg, Wwg, Ss, Gll^Fmw, Gll^Fmw, Gll^Fp, Gll^Fp, Gll^Fp, Re, Gs^Em, Gll^Fmw, Gll^Fmw, Gs^Edb, Gs, Gll^Fp, Gll^Fp, Gll^Fp, Re, Gll^Fmw, Gll^Fmw, Gll^Fdw, Wwg, Wog, Wwg, Wwg, Gll^Fdw, Gll^Fp, Sm, Gll^Fmw, Gs^Vc, Gll^Fmw, Gll^Fmw, Gll^Fp, Gll^Fmw, Gll^Fmw
Wwg, Wwg, Ss, Ss, Gll^Fmw, Gll^Fmw, Ss, Ss, Ss, Ss, Ss, Ss, Gll^Fmw, Gll^Fmw, Re, Re, Gs, Gll^Fp, Re, Re, Gll^Fp, Gll^Fp, Gll^Fmw, Gll^Fp, Re, Gll^Fp, Re, Re, Wwg, Wog, Gll^Fmw, Wwg, Gll^Fmw, Gll^Fp, Sm^Em, Gll^Fp, Re, Re, Re, Gll^Vhs, Gll^Fp, Gll^Fp
Gll^Fmw, Ss, Hhd^Fmw, Ss, Gll^Fmw, Gll^Fp, Hhd^Fp, Hhd^Fp, Gll^Fmw, Ss, Gll^Fdw, Gll^Fp, Re, Ss^Bw/r, Gll^Fp, Gll^Fmw, Gll^Fmw, Gs, Gll^Vht, Gll, Gll, Gll^Fp, Gll^Fmw, Gll^Fp, Gs^Edb, Re, Re, Wwg, Wwg, Wwg, Wwg, Gll^Fmw, Gll^Fp, Sm^Edb, Sm^Edb, Sm^Em, Sm^Edb, Sm, Re, Gll^Fmw, Gll^Fmw, Gll^Fmw
Hhd^Fmw, Hhd^Fmw, Hhd, Hhd^Fp, Hhd, Gll^Fmw, Gll^Fmw, Gll^Fmw, Gll^Fmw, Gll^Fmw, Gs, Gll^Fp, Re, Re, Gll^Fmw, Gs^Fmw, Gll^Fmw, Sm, Sm, Sm, Gll, Gll^Fp, Gll^Fmw, Gll^Fmw, Gs^Edb, Gll^Vhs, Gll^Fp, Ww^Bw\r, Re, Gll^Fp, Gll^Fmw, Gll^Fp, Gll, Gll^Fp, Gll^Fp, Gll^Fmw, Sm^Edb, Sm, Gll^Fmw, Gll^Fp, Gll^Fmw, Gll^Fmw
Xue, Hhd^Fp, Hhd^Fp, Hhd^Fp, Gll^Fp, Hhd^Fmw, Hhd^Fmw, Hhd^Fmw, Gll^Fmw, Gll^Vhs, Gs^Em, Re, Gll^Fmw, Gll^Fmw, Gll^Fmw, Gll^Fmw, Sm^Em, Sm^Em, Sm^Em, Gll^Fp, Gll^Fmw, Gll^Fmw, Sm^Em, Gll^Fmw, Gll^Fmw, Gll^Fmw, Gll^Fp, Ww, Gll^Fdw, Re, Gs^Edb, Gll^Fp, Gs^Vhs, Gll, Gll^Fmw, Gll^Fmw, Sm^Em, Gll^Fmw, Gll^Fp, Gll^Fmw, Gll^Fp, Gll^Fmw
Xue, Xue, Xue, Xue, Xue, Hhd^Fp, Hhd, Gll^Fmw, Gll^Fdw, Gll^Fp, Gs^Em, Gll^Fmw, Hhd^Fmw, Gll^Fp, Hhd^Fmw, Hhd^Fp, Hhd^Fmw, Gll^Fmw, Gll^Fmw, Gs, Gll^Fmw, Gll^Fmw, Sm, Gll^Fmw, Sm^Em, Gll^Fmw, Ww, Ww, Gll^Fmw, Gll^Fp, Gll^Fmw, Gs, Gll^Fp, Gll^Fmw, Gll^Fp, Gll^Fmw, Gll^Fmw, Gll^Fp, Gll^Fp, Gd^Fetd, Gll^Fmw, Gll^Fmw
Uhe, Xue, Xue, Xue, Uue^Vu, Xue, Xue, Xue, Rb^Edb, Rb^Edb, Rb^Edb, Xue, Hhd^Fmw, Hhd^Fmw, Gll^Fp, Hhd, Hhd^Fmw, Gll^Fmw, Gll^Fp, Gs^Em, Gs^Vhs, Sm^Em, Gll^Fmw, Sm, Gll^Fp, Sm, Ww, Gll^Fdw, Gll^Fmw, Gll^Fp, Gll^Fmw, Gs^Em, Gs^Em, Gll^Fmw, Gll^Fp, Gll^Fmw, Re, Gll^Fmw, Gll^Fmw, Gll^Fmw, Gll^Fmw, Gll^Fp
Uue, Uhe, Uue^Vu, Xue, Uhe, Uue^Tf, Uue, Uue, Rb^Edb, Rb^Edb, Uhe, Xue, Xue, Hhd^Fdw, Gll^Fp, Hhd^Fmw, Hhd^Fmw, Hhd^Fp, Gll, Gll^Fp, Gll^Fp, Gll^Fmw, Gll, Gll^Fp, Gll^Fp, Gll^Fp, Ww, Gll^Fmw, Gll^Fmw, Sm^Em, Gll^Fmw, Gll^Fp, Gll^Fp, Gs, Re, Re, Gll^Fmw, Gll^Fp, Gll^Fmw, Gll^Vhs, Gll^Fmw, Gll^Fp
Uue, Uue, Uue, Xue, Uhe, Uue, Cer, Rb, Rb^Edb, Uhe, Uue, Uue^Vu, Xue, Hhd^Fmw, Hhd^Fp, Sm^Em, Sm, Hhd^Fp, Gll, Gll^Fdw, Sm^Em, Gll^Fmw, Gll^Fmw, Gll^Fdw, Gll^Fmw, Wog, Sm, Gll^Vhs, Sm, Sm^Em, Gll^Fdw, Gll^Fmw, Gll^Fmw, Gll^Fdw, Gll^Fdw, Re, Gs^Em, Gll^Fmw, Hhd^Fmw, Gll^Fmw, Gll^Fmw, Gll^Fp
Uue, Uhe, Uue, Uue^Edb, Uue^Edb, Cer, 5 Ker, Cer, Rb, Uhe, Uue, Uue^Tf, Xue, Xue, Hhd, Sm^Em, Gll^Fmw, Sm^Em, Gll^Fmw, Gll^Fp, Sm, Gll^Fp, Sm, Wwg, Gll^Fmw, Wog, Sm, Sm, Sm^Em, Gll^Fmw, Gll^Fp, Gll^Fmw, Gll^Vht, Gll^Fmw, Gll^Fmw, Re, Gll^Fmw, Hhd^Fp, Hhd^Fmw, Gll^Fp, Gll^Fp, Gll^Fp
Xue, Uhe, Xue, Uhe, Uue, Cer, Cer, Cer, Rb^Edb, Uue, Uue^Vu, Uue^Tf, Xue, Xue, Hhd, Hhd^Fp, Hhd^Fmw, Gll^Fdw, Sm, Gs, Gs^Vc, Sm^Em, Wwg, Wwg, Wog, Wog, Gll^Fmw, Gll^Fmw, Wwg, Gll^Fmw, Gll^Fmw, Gll^Fmw, Gll^Fmw, Gll^Fp, Gs, Re, Gll^Fmw, Hhd^Fmw, Gll^Fp, Gll^Fp, Gll^Fmw, Gll^Fmw
Xue, Uhe, Xue, Uhe, Uue^Vu, Uue, Uue, Rb^Edb, Rb^Edb, Xue, Xue, Xue, Xue, Xue, Hhd^Fp, Hhd^Fmw, Sm^Em, Sm^Em, Sm, Gs, Gll^Fmw, Gll^Fdw, Wwg, Wog, Gll^Fp, Wog, Gll^Fmw, Gll^Fp, Wwg, Hhd^Fp, Hhd^Fp, Gll^Fp, Gll^Fmw, Gs^Em, Gll^Fmw, Gll^Fp, Hhd^Fmw, Hhd^Fdw, Hhd^Fmw, Gll^Fmw, Hhd^Fmw, Gll^Fmw
Xue, Xue, Xue, Xue, Xue, Xue, Uhe, Uue, Xue, Rb^Edb, Re, Gll^Fp, Gll^Fmw, Hhd^Fmw, Gll^Fmw, Hhd^Fp, Sm^Em, Sm, Sm^Em, Gs, Gll^Fmw, Gll^Fmw, Gll^Fp, Wog, Gll^Fmw, Gll^Fp, Gll^Fmw, Gll^Fp, Hhd^Fp, Hhd, Hhd^Fmw, Gll^Fmw, Gll^Fmw, Gs, Gll^Fmw, Hhd^Fmw, Hhd^Fp, Hhd^Fmw, Hhd^Fmw, Hhd^Fp, Hhd^Fdw, Gd^Fp
Hhd^Fmw, Xue, Hhd, Xue, Xue, Xue, Xue, Uue^Vu, Xue, Gll^Fmw, Gll^Fmw, Re, Gll^Fp, Gll^Fmw, Gll^Fp, Gll^Fmw, Gll^Fmw, Gll^Fdw, Gll^Fp, Gll^Fdw, Gll^Fp, Gll^Fmw, Gll^Fmw, Wwg, Wwg, Gll^Vhs, Gll^Fp, Hhd^Fp, Hhd^Fmw, Hhd, Xue, Xue, Rb, Rb, Uue, Xue, Xue, Xue, Xue, Hhd, Hhd^Fp, Gd^Fp
Hhd, Hhd^Fmw, Gll^Fp, Hhd^Fp, Hhd, Xue, Hhd^Fp, Xue, Gll^Fmw, Gll^Fp, Gll^Fmw, Re, Gll^Vht, Gll^Fp, Gs, Gll^Fp, Gs, Gs, Gll^Fmw, Gll, Sm, Gll^Fp, Wwg, Gll^Fmw, Wwg, Gll^Fdw, Hhd^Fmw, Hhd^Fp, Xue, Xue, Xue, Xue, Rb, Rb^Edb, Uue, Xue, Uhe, Xue, Xue, Xue, Hhd, Hhd^Fmw
Hhd^Fp, Gll^Fmw, Gll^Fdw, Hhd^Fmw, Hhd^Fmw, Hhd, Hhd^Fmw, Gll^Fmw, Gll^Fmw, Gll^Fmw, Gll^Fp, Gs, Gs, Gll^Fmw, Gll^Fmw, Gs^Edb, Gs^Em, Gll^Fmw, Gll^Fp, Gll, Sm, Gll^Fdw, Gll^Fp, Wwg, Wog, Gll^Fmw, Hhd, Hhd^Fmw, Xue, Xue, Uhe, Xue, Rb^Edb, Rb^Edb, Uue, Uue^Vu, Uhe, Xue, Xue, Xue, Xue, Hhd^Fp
Gll^Fp, Gll^Fmw, Gll^Fmw, Gll^Fp, Gll^Fmw, Hhd^Fp, Gll^Fp, Gll^Fp, Gd^Fetd, Gll^Fmw, Gll^Fmw, Gll^Fmw, Re, Gs, Gs, Gs, Gs, Gll^Fmw, Sm, Gll^Fdw, Sm, Sm, Wwg, Wog, Wog, Wog, Hhd^Fp, Xue, Xue, Xue, Uue, Uhe, Rb^Edb, Uue^Edb, Uhe, Uhe, Uhe, Uue, Uue, Xue, Xue, Xue
Gll^Fp, Gll^Fmw, Gll^Fmw, Gll^Fmw, Gll^Fp, Gll^Fmw, Gll^Fmw, Gll^Fmw, Gll^Fp, Gll^Fmw, Re, Re, Gll^Fmw, Gll^Fmw, Gll^Fp, Gll^Fmw, Re, Gs, Sm, Gll^Fmw, Sm, Gll^Fmw, Wwg, Wog, Hhd^Fmw, Hhd^Fmw, Xue, Xue, Xue, Uue^Vu, Uue, Rb^Edb, Rb^Edb, Uue, Xue, Xue, Xue, Xue, Uue, Xue, Xue, Xue
Sm, Gll^Fp, Gll^Fp, Gll^Fp, Gll^Fp, Gll^Fdw, Gll^Vhs, Gll^Fmw, Gll^Fdw, Gll^Fdw, Re, Gll^Fmw, Gll^Fmw, Gll^Fmw, Gll^Vhs, Gll^Fmw, Gll, Re, Re, Sm, Gll^Fp, Gll^Fp, Wwg, Wwg, Hhd^Fmw, Gll^Fp, Xue, Xue, Xue, Xue, Uue^Edb, Rb^Edb, Uue, Uue^Vu, Xue, Xue, Uue, Xue, Uue, Xue, Xue, Xue
Sm, Gll^Fmw, Sm, Gll^Fp, Sm, Gll^Fmw, Gll, Gll^Fmw, Gs, Re, Gll^Fmw, Gll^Fp, Gll^Fdw, Gll^Fp, Gll^Fmw, Gll^Fmw, Gll, Gll^Fmw, Gll^Fmw, Re, Re, Wwg, Gll^Fmw, Gll^Fmw, Hhd^Fp, Hhd, Hhd^Fmw, Xue, Xue, Xue, Uhe, Uue, Uue, Xue, Uue, Uue, Cer, Uue, Uue, Xue, Xue, Xue
Sm, Gll^Fmw, Sm^Edb, Sm^Edb, Gll^Fmw, Gll^Fdw, Gll^Fmw, Gs, Gll^Fmw, Gll^Fp, Gll^Fmw, Gll^Fmw, Gll^Fp, Gll^Fp, Sm^Edb, Sm^Edb, Gll^Fmw, Gll^Fmw, Gll^Fp, Gll^Fp, Wwg, Wwg^Bw\r, Re, Gll^Fmw, Gll^Fmw, Gll^Fmw, Gll^Fmw, Hhd^Fmw, Xue, Uhe, Uue^Vu, Rb, Uue, Uue, Rb^Edb, Cer, 6 Ker, Cer, Uue, Uhe, Xue, Xue
Sm, Sm, Sm, Sm^Edb, Gll^Fp, Gll^Fmw, Gll^Vc, Gs^Edb, Gll^Fmw, Gll^Fmw, Gll^Fmw, Gll^Fdw, Gll^Fmw, Gll^Fp, Sm^Edb, Sm^Edb, Sm^Edb, Sm, Gll^Fmw, Gll^Fmw, Wwg, Wog, Wog, Gs^Em, Gs, Re, Re, Hhd^Fmw, Re, Rb^Edb, Rb^Edb, Rb^Edb, Rb^Edb, Rb^Edb, Uue, Cer, Cer, Cer, Uue, Uhe, Uue^Vu, Xue
Gll^Fp, Gll^Fmw, Gll^Fmw, Sm, Gll^Fp, Gll^Fdw, Gll^Fdw, Gs^Em, Gll^Fp, Gll^Vhs, Gll^Fp, Gll^Fmw, Gll^Fmw, Gll^Fmw, Sm, Sm, Sm^Edb, Gll^Fp, Gll^Fmw, Gll^Fmw, Gll^Fmw, Gll^Fmw, Wog, Gll^Fp, Gll^Fmw, Gll^Fp, Gll^Fmw, Re, Re, Rb^Edb, Uue, Rb^Edb, Rb^Edb, Rb^Edb, Rb^Edb, Uue, Uue, Uhe, Uhe, Uue, Uue, Uue
Gll^Fp, Gll^Fmw, Gll^Fmw, Gll^Fp, Gll^Fmw, Gll^Fmw, Gs, Gs, Re, Gll^Fmw, Gll, Gll^Fp, Gll^Fmw, Gll^Fmw, Gll^Fmw, Gll^Fp, Gll^Fmw, Gll^Fp, Gll^Fmw, Gll^Vht, Gll^Fp, Gll^Fmw, Gll^Fmw, Wog, Wog, Wog, Gll^Fmw, Gll^Fmw, Hhd^Fmw, Xue, Xue, Uue, Uue, Rb^Edb, Rb, Uue^Edb, Uue, Uhe, Uhe, Uue, Uhe, Uue
Gll^Fmw, Gll^Fmw, Gll^Fp, Gll^Fmw, Gll^Vhs, Gs, Gll^Em, Gll^Fp, Re, Gll^Fp, Gll, Gll^Fmw, Gll^Vhs, Gll^Fmw, Gll^Fdw, Gll^Fmw, Gll^Fmw, Gll^Fdw, Gll^Em, Gll^Fp, Gll^Fp, Gll^Fmw, Gll^Fmw, Wog, Wog, Gll^Fp, Hhd, Gll^Fdw, Hhd, Xue, Xue, Xue, Xue, Uhe, Uue^Vu, Rb, Rb, Uue, Uhe, Uue^Vu, Uhe, Uue
Gs^Fp, Gll^Fp, Gll^Fp, Gll^Fp, Gll^Fp, Gll^Em, Gll^Fp, Gll^Fmw, Gll^Fdw, Re, Re, Gll^Fmw, Gll^Fdw, Gll^Fp, Gll^Fp, Gd^Fetd, Gll^Fp, Gll^Fmw, Gs^Em, Gs^Edb, Gll^Fmw, Gll^Fp, Gll^Fmw, Gll^Fp, Wog, Wog, Hhd^Fmw, Hhd^Fp, Hhd^Fp, Hhd^Fmw, Xue, Xue, Xue, Uhe, Uhe, Uue, Uue, Rb, Uue, Uhe, Uhe, Uhe
Gs^Fp, Gll^Fp, Gll^Fdw, Gll^Fmw, Gll^Fmw, Gll^Fmw, Gll^Fp, Gll^Fp, Gll^Fmw, Gll^Fmw, Re, Gll^Fmw, Gll^Fp, Gll^Fp, Gll^Fp, Gll^Fmw, Gll^Fmw, Gll^Fmw, Gs, Gs, Gs, Gs, Gll^Fmw, Gll^Fmw, Wog, Wog, Gll^Fmw, Hhd^Fmw, Hhd^Fp, Hhd^Fmw, Hhd^Fp, Hhd, Xue, Xue, Xue, Uue, Uue, Uue, Uue, Uhe, Uue, Uhe
