Gg, Gg, Gg, Gg, Gg, Gs, Gs, Gll^Fp, Gs, Gll^Fp, Gll^Fmf, Gll^Fp, Gll^Fp, Gll^Fp, Gll^Fmf, Gll^Fp, Gll^Fp, Gll^Fp, Gll^Fp, Gll^Fmf, Gll^Fmf, Gll^Fmf, Gll^Fmf, Ww, Ww, Ww, Gll^Fp, Gll^Fp, Gll^Fp, Gll^Fp, Gll^Fp, Gll^Fp, Gll^Fp, Gll^Fp, Gll^Fp, Gll^Fp, Re, Gs
Gg, Gg, Gg, Gs, Gs^Fmf, Gs, Gs, Gll^Fp, Gll^Fp, Gll^Fmf, Gll^Fp, Gll^Fmf, Gll^Fmf, Gll^Fmf, Gll^Fp, Gll^Fp, Gll^Fp, Gll^Fp, Gll^Fp, Gll^Fmf, Gll^Fp, Gll^Fp, Ww, Ww, Wo, Ww, Ww, Gll^Fp, Gll^Fp, Gll^Fp, Gll^Fms, Gll^Fms, Gll^Fp, Gll^Fp, Re^Es, Gll^Fp, Gll^Fms, Gll^Fp
Gg, Gg, Gs^Vh, Gs, Gs^Fmf, Gs^Fmf, Gs^Fmf, Gll^Fp, Gs, Gs^Fms, Gll^Fp, Gll^Fmf, Hh^Fmf, Gll^Fmf, Gll^Fp, Gll^Fp, Gll^Em, Gll^Fp, Gll^Fmf, Gll^Fmf, Gll^Fp, Gll^Fp, Ww, Ww, Wo, Wo, Wo, Ww, Gll^Fp, Gll^Fp, Gll^Fms, Gll^Fp, Gll^Fms, Gd^Fetd, Re, Gll^Fp, Gll^Fms, Gll^Fp
Gg, Gg, Gg, Gg, Gg, Gs^Fdf, Gs^Fmf, Gll^Fp, Gll^Fp, Gs, Hh^Fp, Hh^Fp, Hh^Fp, Gll^Fp, Gs^Vl, Gs, Gll^Fp, Gll^Fmf, Gll^Fmf, Gll^Fmf, Gll^Fp, Gll^Fp, Gll^Fp, Ww, Ww, Wo, Ww, Ww, Gll^Fp, Gll^Fp, Gs, Gll^Fms, Gll^Fms, Gs^Em, Gll^Fp, Gll^Fms, Gll^Fp, Gll^Fp
Rp, Gg, Ce, Ce, Ce, Gs^Fmf, Re^Vct, Gs^Fmf, Gll^Fp, Gll^Fp, Gll^Fmf, Gs^Fdf, Hh^Fmf, Gll^Fp, Gs^Em, Gll^Fp, Gll^Fp, Gll^Fmf, Gd^Fdf, Gll^Fmf, Gd^Fmf, Ss, Gll^Fp, Ww, Gd^Fp, Ww, Ww, Gll^Fp, Gll^Fp, Gs^Vc, Re, Gll^Fp, Gll^Fp, Gll^Fp, Ww, Gll^Fp, Ww, Ww
Rp, Rp, Rp, 3 Ket, Ce, Gs^Fmf, Re^Ecf, Re^Vct, Gll^Fp, Gs^Fmf, Hh^Fmf, Hh^Fmf, Hh^Fp, Gll^Fp, Gll^Fp, Re, Gd^Fmf, Gll^Fmw, Gd^Fmf, Gll^Fmf, Gd^Fmf, Ss, Ww^Ewl, Ww, Gd^Fp, Gd^Fp, Ww, Gll^Fp, Ww, Gll^Fp, Re, Gs^Em, Gll^Fms, Ww, Gs^Fp, Ww, Gs^Fms, Gll^Fp
Gg, Rp, Re, Rp, Re^Es, Re^Es, Re, Gs^Fms, Gll^Fp, Gll^Fp, Gll^Fp, Gll^Fp, Gll^Fp, Hh^Fmf, Gll^Fp, Re, Gll^Fp, Gd^Fmw, Gd^Fp, Ss, Ss, Rb^Em, Ss, Gd^Fp, Gll^Vhs, Gd^Fp, Gd^Fp, Ww, Ww, Gll^Fp, Ww^Bw|r, Gll^Fms, Ww, Ww, Gs^Fms, Gs^Fms, Gll^Fms, Gll^Fp
Gg, Re, Gg, Ch, Gs, Rp, Rp, Re, Rp^Es, Rb^Es, Rp^Es, Gd, Gd^Fp, Gll^Fmf, Gll^Fdf, Gll^Fmw, Gll^Fmf, Gll^Fmw, Gll^Fp, Ss, Gd^Fmf, Rb^Em, Ss, Gd^Fp, Gs, Gs^Em, Gs^Em, Gll^Fp, Gll^Fmf, Ww, Gll^Fp, Ww, Gs^Fp, Gs^Fp, Gs, Gll^Fp, Gll^Fms, Gll^Fp
Gg, Gg, Gs^Vh, Gs, Gs, Gll^Fp, Gs, Rp, Gll^Fp, Rp, Re^Es, Rb, Rb, Gd^Fmw, Gd^Fmf, Gs^Fp, Gll^Fmw, Gll^Fmw, Gs, Gll^Fmf, Gd^Fmf, Gd^Fp, Gll, Gd^Fp, Hhd^Fp, Gll^Fp, Gll^Fms, Hh^Fmf, Gll^Fmf, Gll^Fms, Gll^Fms, Gll^Fms, Gll^Fms, Gll^Fp, Gs, Gll^Vhs, Re, Re
Gs, Gs, Gll^Fp, Gs^Fms, Gs, Gll^Fp, Gs, Gll^Fmw, Gll^Fmw, Rp, Re, Rp, Gd^Fdw, Rb, Gd^Fp, Ss, Gs^Fp, Gll^Fmw, Gd, Gll^Fp, Gll^Fp, Gd^Fp, Gll, Gll^Fp, Hhd^Fms, Gll^Fp, Hh^Fp, Hh, Hh^Fms, Hh^Fms, Gll^Fp, Gll^Fmf, Gll^Fms, Gll^Fms, Gll^Fms, Re, Gll^Fp, Gll^Fp
Gll^Fp, Gll^Fp, Gll^Fp, Gs, Gll^Fp, Gll^Fp, Hh^Fp, Hh^Fp, Hh^Fmw, Gll^Fp, Gs^Fp, Re, Rp, Rb, Rb, Ss, Gs^Fp, Gs^Fp, Gll^Fmf, Gll^Vhs, Re, Gd, Gd^Fdf, Hh^Fp, Gll^Fp, Gs, Hh^Fp, Gll^Fp, Gs, Gll^Fp, Ce, Gll^Em, Gll^Feth, Gll^Fms, Gs^Efm, Re, Gll^Fp, Gll^Fp
Gs, Gll^Fp, Gll^Fp, Gll^Fmw, Gs, Gll^Fp, Gll^Fmw, Hh, Hh^Fmf, Gll^Fmf, Gd^Fmw, Ww, Rb^Es, Rp, Ss, Ss, Ss, Ss, Gs^Fmf, Gll^Fdf, Re, Gll^Fp, Gd^Fmf, Gll^Fmf, Gll^Fmw, Gs, Gs^Fmf, Gll^Fmf, Gs, Ce, 1 Ke, Re^Ecf, Gll^Em, Gll^Fp, Gll^Fmf, Gll^Fp, Hh^Fp, Hh^Fp
Gll^Fp, Gs, Gll^Fp, Gs, Gll^Fdf, Gs, Gll^Fp, Hh, Hh^Fmf, Gd^Fmw, Gs^Fp, Ww^Ewl, Rb^Es, Rp, Re, Ss, Rp, Gll^Fp, Gd^Fetd, Gd^Fmf, Gll^Fdf, Gll^Fdf, Gd, Gll^Fp, Gll^Fmw, Hh^Fp, Gll^Fp, Gll^Fmf, Gll^Fp, Ce, Ce, Ce, Gll^Fmf, Gll^Fmf, Hh^Fp, Hh^Fp, Hhd^Fp, Hhd^Fp
Gll^Fp, Gll^Fp, Gs, Gll^Fmw, Gll^Fmw, Gll^Fp, Hh^Fmf, Hh^Fmf, Gll^Fp, Hh^Fdf, Hh^Fp, Gs^Fp, Gll^Fp, Re^Es, Rp, Rp^Es, Rp, Rp^Es, Gd^Fmf, Gd^Fmf, Gll^Fmf, Gs^Fmf, Gll^Fmf, Gll^Fdf, Hh^Fmw, Hhd^Fp, Hhd^Fp, Gll^Fmw, Gs, Gs, Gll^Fmf, Gs, Gll^Fmf, Gll^Fmf, Hh^Fp, Hh, Hh^Fp, Hh^Fp
Gs, Gll^Fp, Gd^Fp, Gll^Fp, Gll^Fmw, Gll^Fmf, Gll^Fp, Gll^Em, Gs, Gll^Fp, Gll^Fp, Gd^Fp, Gs^Fp, Gs, Rp, Gd^Fdw, Rp, Rp, Ss, Gd^Fp, Gd^Fdf, Gd^Fmf, Gll^Fmf, Hh^Fmw, Gll^Fmw, Hhd^Fp, Gll^Fp, Gs, Gll^Fmf, Gll^Fmf, Gll^Fmf, Gll^Fp, Hh^Fp, Hh^Fp, Gs, Gll^Fp, Hh^Fp, Hhd^Fp
Gs, Gs, Gd^Fp, Gll^Fmw, Hh^Fp, Gll^Fp, Gll^Em, Gll^Em, Gs, Gs^Vl, Gll^Fp, Gll^Fp, Gll^Fmf, Gll^Fmf, Gll^Fp, Ss, Ss, Ss^Bw\r, Rb^Es, Gd^Fmf, Gd^Fdw, Gd^Fp, Gd, Gll^Fmf, Gll^Fp, Gll^Fmw, Gll^Fp, Gll^Fmw, Gll^Fp, Gs, Gll^Fmf, Hh^Fp, Hh^Fp, Gll^Fp, Gs, Gll^Fp, Gll^Fp, Hh^Fp
Ss, Ss, Ss, Gd^Fmf, Gd^Fmf, Gll^Fmw, Gll^Fdf, Gll^Em, Gll^Fp, Gll^Fp, Gll^Fp, Gll^Em, Gll^Fdf, Gll^Fmf, Gll^Fp, Ss, Ss, Rp, Re, Rp, Rp, Gd^Fdw, Re, Gd, Rp, Gll^Fmf, Gll^Fp, Gs, Gs, Gs^Efm, Gs, Gll^Fp, Gll^Fp, Gll^Fp, Gs, Gll^Vhs, Gll^Fp, Hh^Fp
Ss, Ss, Ss, Gd^Fdf, Gd^Fmf, Ss, Gll^Fmf, Gll^Fmw, Gll^Fp, Gll^Fp, Ss, Gll^Fp, Gll^Fp, Gll^Fmf, Gll^Fp, Ss, Gll^Fmf, Gll^Fp, Gll^Fp, Re, Gs^Fp, Re, Gs^Fp, Rp, Rp, Gll^Fdw, Gll^Fp, Gs^Vl, Gll^Fp, Gll^Fp, Gll^Fmf, Gll^Fmw, Gll^Fp, Gs, Gll^Fp, Gs, Gll^Fp, Gll^Fp
Ss, Ss, Gll^Fp, Ss, Gll^Fp, Gll^Fp, Gll^Fdf, Gll^Fmf, Gd^Fmw, Ss, Gll^Fmw, Gll^Fmw, Gll^Fp, Gll^Fp, Gll^Vht, Gll^Fp, Gll^Fmf, Gll^Fp, Gll^Fp, Gs^Fp, Gs^Fp, Gs^Fmf, Gs^Fp, Rp^Es, Rb^Es, Rp, Rb, Gll^Fp, Gll^Fp, Gll^Fp, Gll^Fmw, Hh^Fmw, Hh^Fp, Hh, Hhd^Fp, Gll^Fp, Hh^Fp, Hh^Fp
Gll^Fp, Gll^Fmf, Gll^Fmf, Gll^Fmf, Gll^Fp, Gll^Fp, Gll^Em, Gll^Fmf, Gd^Fmf, Gll^Fp, Gll^Fmf, Gll^Fp, Gll^Fp, Gll^Fp, Gll^Fp, Gll^Fp, Gll^Fdf, Gs^Em, Gll^Fmw, Gll^Fmw, Ss, Gs^Fmf, Gs^Fmf, Rp, Rp, Gd^Fdw, Gd^Fdw, Rp, Rp^Es, Gll^Fp, Gll^Fp, Gll^Fp, Gll^Fp, Gll^Fp, Hh^Fmw, Hhd, Hhd, Hh^Fp
Gd^Fmf, Gd^Fmw, Gd^Fmf, Gll^Fp, Gll^Fp, Gll^Vhs, Gll^Em, Gll^Fp, Gll^Fp, Gll^Fp, Gll^Fp, Gll^Fp, Gll^Em, Gd, Gll^Em, 2 Gll^Fp, Gll^Fmf, Gll^Fp, Gll^Fmf, Gll^Fp, Gll^Fp, Gs^Fmw, Gs^Fdf, Gs^Fdf, Gs^Fmf, Rb, Re, Re^Es, Rp^Es, Rp^Es, Re, Re, Gd^Fdw, Gll^Fp, Gll^Fp, Hh^Fp, Hhd^Fmw, Hhd^Fmw
Gd^Fp, Gd^Fp, Gd^Fmw, Gd^Fmf, Gll^Fmf, Gs, Gll^Fp, Gd, Gll^Fmf, Gll^Fmw, Gll^Fp, Gll^Fp, Gll^Fmf, Gll^Fmf, Gll^Fp, Gll^Fp, Gll^Fp, Gll^Fmw, Gll^Fmf, Gll^Fp, Gs^Vl, Gs, Gs^Fp, Gs^Fdf, Gs^Fmf, Gll^Fp, Gs^Fp, Gll^Fp, Gll^Fp, Gs, Gs, Re, Rp^Es, Gd^Fdw, Rp, Gll^Fp, Gll^Fp, Gll^Fp
Gll^Fp, Gll^Fp, Ss, Gd^Fmw, Gd^Fmw, Gll^Fmf, Gll^Fp, Gll^Fp, Gll^Fp, Gll^Fmw, Gll^Fp, Ss, Ss, Gll^Fmf, Gd^Fetd, Gll^Fp, Ss, Gll^Fmw, Gll^Fp, Gll^Fp, Gd, Gd, Gs, Gs^Fmf, Gll^Fmw, Gll^Fp, Ss, Gll^Fmf, Gll^Fmw, Gll^Fmw, Gll^Fp, Gd^Fdw, Rp^Es, Rp^Es, 4 Re^Es, Rp, Rp, Rp
Ss, Ss, Gll^Fp, Gll^Fp, Gll^Fp, Gll^Fmf, Gll^Fmw, Gll^Fp, Gs^Em, Gll^Em, Gll^Fp, Ss, Ss, Ss, Ss, Ss, Gll^Fmw, Gll^Fmw, Ss, Gll^Fmf, Gll^Fmf, Gll^Fp, Gll^Fmf, Gll^Fmw, Ss, Ss, Gll^Fp, Gll^Fp, Gll^Fmw, Gll^Fp, Gll^Fmf, Gll^Fp, Gll^Fp, Rp, Gll^Fp, Re, Rp, Rp
Ss, Ss, Ss, Ss, Gll^Fmw, Gd^Fmw, Gll^Fmw, Gll^Fp, Gll^Fp, Ss, Ss, Ss, Ss, Gll^Fp, Gll^Fp, Ss, Gll^Em, Gll^Fmw, Gll^Fdf, Ss^Fdf, Ss, Gll^Fmw, Gll^Fmf, Gll^Fp, Gll^Fp, Ss, Gll^Fmw, Gll^Fp, Gs, Gll^Fp, Gll^Fmf, Gll^Fmw, Gll^Fp, Gll^Fp, Gll^Fmf, Gll^Fp, Gll^Fp, Gll^Fp
Gll^Fp, Gll^Fp, Gll^Fmw, Gll^Fmw, Gd^Fp, Gd^Fp, Gll^Fp, Gll^Fp, Gll^Fmw, Gll^Fp, Gll^Fp, Ss, Ss, Gll^Fp, Gs^Vl, Gd, Gd^Fp, Gll^Fmw, Gll^Fmw, Ss, Gll^Fp, Gll^Fp, Gll^Fmw, Ss, Gll^Fmw, Gll^Fmw, Gs^Vhs, Gs^Em, Gll^Fp, Gll^Fp, Gll^Fp, Gll^Fmw, Gll^Fmf, Gll^Fmf, Gll^Fmf, Gll^Fmw, Gll^Fp, Gll^Fp
Gll^Fp, Ss, Gll^Fmw, Gd^Fmw, Gll^Fp, Gll^Vht, Gd^Fp, Gd^Fp, Gll^Fmw, Gs, Gll^Fp, Gll^Fp, Gll^Fp, Gll^Fp, Gd^Fmw, Gd^Fmw, Gll^Fmw, Gll^Fp, Gll^Fp, Ss, Gll^Fmw, Gll^Fmw, Ss, Ss, Gll^Fmw, Gd^Fmf, Gd^Em, Gd^Emf, Gll^Fp, Gll^Fp, Gll^Fp, Gll^Fmf, Gll^Fmf, Gll^Fdf, Gll^Fmw, Gll^Fmw, Gll^Fp, Gll^Fp
Ss, Ss, Gll^Fp, Gll^Fmw, Gll^Fmw, Gll^Fp, Gd^Fp, Gll^Fmw, Gll^Fp, Gll^Fp, Gll^Fmw, Gll^Fp, Gll^Fp, Gll^Fmw, Gll^Fp, Gll^Fp, Ss, Ss, Ss, Gll^Fp, Gll^Fp, Gll^Fp, Gll^Fp, Gll^Fp, Gd^Fmw, Gd^Fmw, Gll^Fp, Gll^Fmw, Gd^Fmw, Gd^Fmw, Gll^Fmf, Gll^Fdf, Gll^Fp, Gll^Fmf, Gll^Fdf, Gll^Fdf, Gll^Fmf, Gll^Fp
Gll^Fp, Gll^Fp, Gll^Fp, Gll^Fp, Gll^Fp, Gll^Fmw, Gll^Fp, Gll^Fp, Gll^Fp, Gll^Fmw, Gll^Fp, Gll^Fmw, Gll^Fp, Ss, Ss, Ss, Ss, Ss, Ss, Ss, Ss, Ss, Gll^Fp, Gll^Fp, Gll^Fp, Gll^Fp, Gll^Fp, Gll^Fp, Gll^Fp, Gll^Fmf, Gll^Fmf, Gll^Fmf, Gll^Fmf, Gll^Fmf, Gll^Fmf, Gll^Fmf, Gll^Fmw, Gll^Fmw
