Re, Re, Rr, Gs^Fds, Gs^Fds, Gs^Fds, Gs^Fms, Gs^Fms, Gs^Fms, Gs^Fms, Gs^Fms, Gs^Fp, Gs^Fp, Gs^Fp, Gs^Fp, Gs^Fp, Gll^Fp, Gll^Fp, Gll^Fp, Gll^Fp, Gll^Fp, Wwg, Wog, Wwg, Gll^Fmw, Gll^Fp, Hhd^Fp, Hhd^Fmw, Hhd^Fmw, Xue, Xue, Xue, Xue, Xue, Xue, Xue, Xue, Xue, Xue, Xue, Xue, Xue
Re, Re, 1 Rr, Gs^Fds, Rr, Gs^Fds, Gs^Fms, Gs^Fms, Gs^Fp, Gs^Fmw, Gs^Fms, Gs^Fds, Gs^Fp, Gs^Fp, Gs^Fms, Gs^Fp, Gll^Fp, Gll^Fp, Gll^Fp, Gll^Fp, Wog, Wwg, Wog, Wwg, Gll^Fp, Hhd^Fdw, Hhd, Hhd, Hhd^Fmw, Xue, Xue, Xue, Xue, Xue, Xue, Xue, Xue, Xue, Xue, Xue, Xue, Xue
Gs^Fds, Gs^Fds, Gs^Fms, Rr, Gs^Fms, Rr, Gs^Fms, Gs^Fds, Gs^Fds, Gs^Fds, Gs^Fds, Gs^Fms, Gs^Fms, Gs^Fp, Gs^Fms, Gs^Fp, Gll^Fp, Gll^Fp, Wwg, Gll^Fp, Wog, Wog, Wwg, Gll^Fmw, Gll^Fmw, Hhd^Fp, Hhd, Hhd^Fp, Xue, Xue, Uhe, Uhe^Vu, Uue, Cer, 4 Ker, Cer, Uue^Tf, Xue, Xue, Xue, Xue, Xue
Gs^Fms, Gs^Fds, Gs^Fms, Gs^Fds, Gs^Fms, Rr, 2 Rr, Gs^Fds, Ce, Ce, Gs, Gs^Vh, Gs, Gs^Fp, Gs^Fp, Gs^Fp, Gll^Fp, Gll^Fp, Gll^Fp, Wwg, Wog, Wog, Wwg, Gll^Fp, Gll^Fp, Gll^Fdw, Hhd^Fmw, Hhd^Fmw, Xue, Xue, Uhe^Vu, Re, Re^Edb, Cer, Cer, Cer^Es, Uue^Tf, Xue, Xue, Xue, Xue, Xue
Gg, Gg, Gs^Fms, Gs^Fmw, Gs^Fds, Gs^Fms, Ce, Ke, Rr, Gs, Gs^Vl, Gs, Gs, Gs, Gs^Fp, Gs^Fds, Gll^Fp, Gll^Fp, Wwg, Wog, Gll^Fmw, Gll^Fmw, Gll^Fmw, Hhd^Fmw, Hhd^Fmw, Hhd^Fmw, Xue, Xue, Uue, Uue, Xue, Xue^Edb, Re^Edb, Re^Edb, Re^Edb, Re, Uue^Edb, Xue, Uue^Vu, Xue, Xue, Xue
Gg, Gg, Gs^Fms, Gs^Fp, Gs^Fds, Ce, Gs^Vh, Gs, Gs, Rr, Rr, Gs, Gs^Fp, Gs^Vh, Ce, Gs^Fp, Gll^Fp, Wwg, Wwg, Gll^Fp, Gll^Fp, Gll^Fmw, Gll^Fp, Hhd^Fmw, Hhd^Fmw, Hhd, Xue, Xue, Uue, Xue, Xue, Xue, Uhe, Uhe, Re^Edb, Re, Re^Edb, Uue, Uue^Tf, Xue, Xue, Xue
Gg, Gg, Gs^Fms, Gs^Fp, Gs^Fp, Gs^Fms, Gs, Gs, Gs, Gs, Gs^Fp, Rr, 3 Ke, Ce, Gs^Fp, Gs^Fp, Wwg, Wwg, Wwg, Wwg, Gll^Fp, Gll^Fmw, Gll^Fp, Gll^Fmw, Gll^Fmw, Hhd^Fmw, Xue, Xue, Uue, Uue, Uue^Tf, Uhe, Uhe, Uue^Vu, Re^Edb, Uue, Uue^Edb, Uue, Xue, Xue, Xue, Xue
Gs^Fms, Gs^Fms, Gs^Fms, Gs^Fp, Gs^Fp, Gs^Fp, Gs^Vh, Gs^Fp, Gs, Gs^Fp, Ce, Ce, Rr, Rr, Wwg^Bw\, Wwg, Gll^Fp, Wwg, Wwg, Gll^Fp, Wwg, Wwg, Wwg, Hhd^Fmw, Hhd^Fmw, Hhd^Fmw, Hhd, Xue, Xue, Uue, Re^Edb, Uhe, Re^Edb, Re, Uhe, Uhe, Uue^Edb, Xue, Uue^Vu, Xue, Xue, Xue
Gs^Fms, Gs^Fms, Gs^Fmw, Gs^Fp, Gs^Fp, Gs^Fp, Gs^Fp, Gs^Vh, Gs^Fp, Gs^Fds, Wwg, Wwg, Wwg^Bw|, Wwg, Gll^Fmw, Re, Gll^Fmw, Gll^Fmw, Gll^Fmw, Wwg, Gll^Fmw, Gll^Fp, Gll^Fmw, Wwg, Wwg, Hhd^Fp, Hhd^Fp, Xue, Xue, Xue, Re, Uue^Edb, Uue, Uue, Uhe, Uhe, Uue^Tf, Uue, Uue, Uue, Xue, Xue
Gs^Fp, Gs^Fp, Gll^Fp, Gs^Fms, Gll^Fp, Gs^Fp, Gll^Fp, Gs^Fp, Gll^Fp, Wwg, Gll^Fp, Wwg, Re, Gll^Fmw, Gll^Fmw, Re^Edb, Gs, Gll^Fmw, Gll^Fmw, Gll^Fmw, Gll^Fdw, Gll^Fp, Gll^Fp, Gll^Fp, Wwg, Hhd^Fp, Wwg, Hhd^Fp, Hhd^Fdw, Xue, Re^Es, Re^Es, Xue, Uue^Vu, Uhe, Xue, Xue, Uhe, Xue, Uue^Vu, Xue, Xue
Gll^Fp, Gll^Fp, Gll^Fp, Gll^Fp, Gll^Fp, Gll^Fp, Gll^Fp, Gll^Fp, Gll^Fp, Wwg, Gll^Fp, Gll^Fmw, Re, Gll^Fp, Gll^Fmw, Gll^Fp, Gll^Fp, Re, Gll^Fdw, Gll^Fp, Gll^Fmw, Gll^Fmw, Gll^Fmw, Gll^Fmw, Gll^Fmw, Wwg, Ss, Wwg, Wwg, Hhd^Fmw, Re^Es, Re^Es, Xue, Xue, Xue, Xue, Hhd^Fp, Xue, Hhd, Xue, Hhd^Fmw, Hhd^Ftr
Gll^Fp, Gll^Fp, Gll^Fp, Gll^Fp, Gll^Fp, Gll^Fp, Gll^Fp, Gll^Fp, Wwg, Wwg, Gll^Fmw, Gll^Fmw, Re, Gll^Fmw, Gll^Fmw, Gll^Fp, Gs, Re, Re, Gll^Fmw, Gs^Em, Gll^Fp, Re^Vhs, Gll^Fp, Gll^Fp, Gll^Fp, Re^Vhs, Ss, Ss^Bw/r, Ww^Bw/r, Wwg, Hhd^Fp, Hhd^Fmw, Xue, Hhd, Hhd^Fp, Hhd^Fp, Gll^Fmw, Hhd^Fdw, Hhd, Hhd^Fp, Hhd^Ftr
Gll^Fp, Gll^Fp, Gll^Vhs, Re^Gvs, Gll^Fp, Ss, Gll^Vhs, Wwg, Ss, Gll^Fp, Gll^Fp, Gll^Fmw, Gll^Fp, Gs, Gs, Gll^Fp, Gs, Gll^Fp, Gll^Fmw, Re, Gll^Fmw, Gs, Gs, Gll^Fp, Re, Gll^Fp, Re, Ss^Bw/r, Ss, Wwg, Wog, Wwg, Hhd^Fp, Hhd^Fmw, Gll^Fmw, Hhd^Fp, Hhd^Fmw, Hhd, Gll^Fmw, Hhd^Fp, Gll^Fp, Hhd^Ftr
Gll^Fp, Gll^Fp, Re^Gvs, Gs, Re, Ss^Bw/, Wwg, Wwg, Ss, Ss, Ss, Gll^Fp, Gll^Fmw, Gll^Fmw, Re, Gll^Fmw, Gll^Fmw, Gd^Fetd, Gs^Edb, Gs^Edb, Gll^Fp, Gll^Fp, Gs^Em, Re, Gll^Fp, Re, Gll^Fmw, Gll^Fmw, Gll^Fmw, Wwg, Wog, Wwg, Hhd^Fp, Hhd^Fmw, Gll^Fmw, Hhd^Fp, Gll^Fmw, Hhd^Fmw, Gll^Fp, Gll^Fp, Hhd, Hhd^Ftr
Gll^Fp, Gll^Fp, Gll^Fp, Gll^Fp, Gll^Fp, Re, Wwg, Wwg, Wwg, Ss, Ss, Gll^Fp, Gll^Fp, Re^Vhs, Gll^Fp, Re, Gll^Fp, Gll^Fp, Gll^Fmw, Gll^Fmw, Re, Re, Gll^Fdw, Gs, Gs, Gll^Fmw, Gd^Fetd, Gll^Fmw, Gll^Fmw, Wwg, Wog, Wog, Wwg, Gll^Fmw, Gll^Fdw, Gll^Fmw, Gll^Fp, Gll^Fmw, Hhd^Fmw, Hhd, Hhd, Hhd^Ftr
Gll^Fp, Gll^Fp, Wwg, Wwg, Wwg, Ss^Bw|r, Wwg, Wwg, Wwg, Ss, Gll^Fmw, Gll^Fmw, Gll^Fp, Gll^Fp, Gll^Fp, Re, Gs^Em, Gll^Fmw, Gll^Fmw, Re^Edb, Gs, Gll^Fp, Re^Vhs, Gll^Fp, Re, Gll^Fmw, Gll^Fmw, Gll^Fdw, Wwg, Wog, Wwg, Wwg, Gll^Fdw, Gll^Fp, Ss, Gll^Fmw, Re^Vc, Gll^Fmw, Gll^Fmw, Gll^Fp, Gll^Fmw, Gll^Fmw
Wwg, Wwg, Ss, Ss, Gll^Fmw, Re, Ss, Ss, Ss, Ss, Ss, Ss, Gll^Fmw, Gll^Fmw, Re, Re, Gs, Gll^Fp, Gs, Gs, Gll^Fp, Gll^Fp, Gll^Fmw, Gll^Fp, Re, Gll^Fp, Gs, Gs, Wwg, Wog, Gll^Fmw, Wwg, Gll^Fmw, Gll^Fp, Ss, Gll^Fp, Re, Re^Es, Re, Re^Vhs, Gll^Fp, Gll^Fp
Gll^Fmw, Ss, Hhd^Fmw, Ss, Gll^Fmw, Re, Hhd^Fp, Hhd^Fp, Gll^Fmw, Ss, Gll^Fdw, Gll^Fp, Re, Ss^Bw/r, Gll^Fp, Gll^Fmw, Gll^Fmw, Gs, Re^Vht, Gs, Gs, Gll^Fp, Gll^Fmw, Gll^Fp, Re^Edb, Re, Re, Wwg, Wwg, Wwg, Wwg, Gll^Fmw, Gll^Fp, Sm^Edb, Sm^Edb, Sm^Em, Sm^Edb, Sm, Re, Gll^Fmw, Gll^Fmw, Gll^Fmw
Hhd^Fmw, Hhd^Fmw, Hhd, Hhd^Fp, Hhd, Gll^Fmw, Gll^Fmw, Gll^Fmw, Gll^Fmw, Gll^Fmw, Gs, Gll^Fp, Re, Re, Gll^Fmw, Gs^Fmw, Gll^Fmw, Ss, Sm, Ss, Gs, Gll^Fp, Gll^Fmw, Gll^Fmw, Re^Edb, Re^Vhs, Gll^Fp, Ww^Bw\r, Re, Gll^Fp, Gll^Fmw, Gll^Fp, Gll, Gll^Fp, Gll^Fp, Gll^Fmw, Sm^Edb, Ss, Gll^Fmw, Gll^Fp, Gll^Fmw, Gll^Fmw
Xue, Hhd^Fp, Hhd^Fp, Hhd^Fp, Gll^Fp, Hhd^Fmw, Hhd^Fmw, Hhd^Fmw, Gll^Fmw, Re^Vhs, Re^Em, Re, Gll^Fmw, Gll^Fmw, Gll^Fmw, Gll^Fmw, Sm^Em, Sm^Em, Ss, Gll^Fp, Gll^Fmw, Gll^Fmw, Sm^Em, Gll^Fmw, Gll^Fmw, Gll^Fmw, Gll^Fp, Ww, Gll^Fdw, Re, Re^Edb, Gll^Fp, Re^Vhs, Gll, Gll^Fmw, Gll^Fmw, Ss, Gll^Fmw, Gll^Fp, Gll^Fmw, Gll^Fp, Gll^Fmw
Xue, Xue, Xue, Xue, Xue, Hhd^Fp, Hhd, Gll^Fmw, Gll^Fdw, Gll^Fp, Re^Em, Gll^Fmw, Hhd^Fmw, Gll^Fp, Hhd^Fmw, Hhd^Fp, Hhd^Fmw, Gll^Fmw, Gll^Fmw, Gs, Gll^Fmw, Gll^Fmw, Sm, Gll^Fmw, Sm, Gll^Fmw, Ww, Ww, Gll^Fmw, Gll^Fp, Gll^Fmw, Re, Gs^Fp, Gll^Fmw, Gll^Fp, Gll^Fmw, Gll^Fmw, Gll^Fp, Gll^Fp, Gd^Fetd, Gll^Fmw, Gll^Fmw
Uhe, Xue, Xue, Xue, Uue^Vu, Xue, Xue, Xue, Re^Edb, Re^Edb, Re^Edb, Xue, Hhd^Fmw, Hhd^Fmw, Gll^Fp, Hhd, Hhd^Fmw, Gll^Fmw, Gll^Fp, Gs^Em, Re^Vhs, Sm^Em, Gll^Fmw, Sm, Gll^Fp, Ss, Ww, Gll^Fdw, Gll^Fmw, Gll^Fp, Gll^Fmw, Re^Em, Gs^Em, Gll^Fmw, Gll^Fp, Gll^Fmw, Re, Gll^Fmw, Gll^Fmw, Gll^Fmw, Gll^Fmw, Gll^Fp
Uue, Uhe, Uue^Vu, Xue, Uhe, Uue^Tf, Uue, Uue, Re^Edb, Re^Edb, Uhe, Xue, Xue, Hhd^Fdw, Gll^Fp, Hhd^Fmw, Hhd^Fmw, Hhd^Fp, Re, Gll^Fp, Gll^Fp, Gll^Fmw, Re, Gll^Fp, Gll^Fp, Gll^Fp, Ww, Gll^Fmw, Gll^Fmw, Sm^Em, Gll^Fmw, Gll^Fp, Gll^Fp, Gs, Re, Re, Gll^Fmw, Gll^Fp, Gll^Fmw, Re^Vhs, Gll^Fmw, Gll^Fp
Uue, Uue, Uue, Xue, Uhe, Uue, Cer, Re, Re^Edb, Uhe, Uue, Uue^Vu, Xue, Hhd^Fmw, Hhd^Fp, Sm^Em, Sm, Hhd^Fp, Re, Gll^Fdw, Sm^Em, Gll^Fmw, Gll^Fmw, Gll^Fdw, Gll^Fmw, Wog, Sm, Re^Vhs, Sm, Sm^Em, Gll^Fdw, Gll^Fmw, Gll^Fmw, Gll^Fdw, Gll^Fdw, Gs, Gs^Em, Gll^Fmw, Hhd^Fmw, Gll^Fmw, Gll^Fmw, Gll^Fp
Uue, Uhe, Uue, Uue^Edb, Uue^Edb, Cer, 5 Ker, Cer, Re, Uhe, Uue, Uue^Tf, Xue, Xue, Hhd, Sm^Em, Gll^Fmw, Sm^Em, Re, Gll^Fp, Ss, Gll^Fp, Sm, Wwg, Gll^Fmw, Wog, Sm, Sm, Ss, Gll^Fmw, Gll^Fp, Gll^Fmw, Re^Vht, Gll^Fmw, Gll^Fmw, Gs, Gll^Fmw, Hhd^Fp, Hhd^Fmw, Gll^Fp, Gll^Fp, Gll^Fp
Xue, Uhe, Xue, Uhe, Uue, Cer, Cer^Es, Cer, Re^Edb, Uue, Uue^Vu, Uue^Tf, Xue, Xue, Hhd, Hhd^Fp, Hhd^Fmw, Re, Sm^Bw\r, Sm, Re^Vc, Sm, Wwg, Wwg, Wog, Wog, Gll^Fmw, Gll^Fmw, Wwg, Gll^Fmw, Gll^Fmw, Gll^Fmw, Gll^Fmw, Re, Re, Gs, Gll^Fmw, Hhd^Fmw, Gll^Fp, Gll^Fp, Gll^Fmw, Gll^Fmw
Xue, Uhe, Xue, Uhe, Uue^Vu, Uue, Uue, Re^Edb, Re^Edb, Xue, Xue, Xue, Xue, Xue, Hhd^Fp, Hhd^Fmw, Sm, Sm^Em, Ss, Re, Gll^Fmw, Gll^Fdw, Wwg, Wog, Gll^Fp, Wog, Gll^Fmw, Gll^Fp, Wwg, Hhd^Fp, Hhd^Fp, Gll^Fp, Gll^Fmw, Re^Em, Gll^Fmw, Gll^Fp, Hhd^Fmw, Hhd^Fdw, Hhd^Fmw, Gll^Fmw, Hhd^Fmw, Gll^Fmw
Xue, Xue, Xue, Xue, Xue, Xue, Uhe, Uue, Xue, Re^Edb, Re, Gll^Fp, Gll^Fmw, Hhd^Fmw, Gll^Fmw, Hhd^Fp, Sm^Em, Sm, Sm^Em, Re, Gll^Fmw, Gll^Fmw, Gll^Fp, Wog, Gll^Fmw, Gll^Fp, Gll^Fmw, Gll^Fp, Hhd^Fp, Hhd, Hhd^Fmw, Gll^Fmw, Gll^Fmw, Re, Gll^Fmw, Hhd^Fmw, Hhd^Fp, Hhd^Fmw, Hhd^Fmw, Hhd^Fp, Hhd^Fdw, Gd^Fp
Hhd^Fmw, Xue, Hhd, Xue, Xue, Xue, Xue, Uue^Vu, Xue, Gll^Fmw, Gll^Fmw, Re, Gll^Fp, Gll^Fmw, Gll^Fp, Gll^Fmw, Gll^Fmw, Gll^Fdw, Gll^Fp, Gll^Fdw, Gll^Fp, Gll^Fmw, Gll^Fmw, Wwg, Wwf, Gll^Vhs, Gll^Fp, Hhd^Fp, Hhd^Fmw, Hhd, Xue, Xue, Re, Re, Uue, Xue, Xue, Xue, Xue, Hhd, Hhd^Fp, Gd^Fp
Hhd, Hhd^Fmw, Gll^Fp, Hhd^Fp, Hhd, Xue, Hhd^Fp, Xue, Gll^Fmw, Gll^Fp, Gll^Fmw, Re, Re^Vht, Gll^Fp, Gs, Gll^Fp, Re, Re, Gll^Fmw, Re, Sm, Gll^Fp, Wwg, Gll^Fmw, Wwg, Gll^Fdw, Hhd^Fmw, Hhd^Fp, Xue, Xue, Xue, Xue, Re, Re^Edb, Uue, Xue, Uhe, Xue, Xue, Xue, Hhd, Hhd^Fmw
Hhd^Fp, Gll^Fmw, Gll^Fdw, Hhd^Fmw, Hhd^Fmw, Hhd, Hhd^Fmw, Gll^Fmw, Gll^Fmw, Gll^Fmw, Gll^Fp, Re, Re, Gll^Fmw, Gll^Fmw, Gs^Edb, Gs^Em, Gll^Fmw, Gll^Fp, Re, Sm, Gll^Fdw, Gll^Fp, Wwg, Wog, Gll^Fmw, Hhd, Hhd^Fmw, Xue, Xue, Uhe, Xue, Re^Edb, Re^Edb, Uue, Uue^Vu, Uhe, Xue, Xue, Xue, Xue, Hhd^Fp
Gll^Fp, Gll^Fmw, Gll^Fmw, Gll^Fp, Gll^Fmw, Hhd^Fp, Gll^Fp, Gll^Fp, Gd^Fetd, Gll^Fmw, Gll^Fmw, Gll^Fmw, Gs, Gs, Gs, Gs, Gs, Gll^Fmw, Ss, Gll^Fdw, Sm, Sm, Wwg, Wog, Wog, Wog, Hhd^Fp, Xue, Xue, Xue, Uue, Uhe, Re^Edb, Uue^Edb, Uhe, Uhe, Uhe, Uue, Uue, Xue, Xue, Xue
Gll^Fp, Gll^Fmw, Gll^Fmw, Gll^Fmw, Gll^Fp, Gll^Fmw, Gll^Fmw, Gll^Fmw, Gll^Fp, Gll^Fmw, Re, Gs, Gll^Fmw, Gll^Fmw, Gll^Fp, Gll^Fmw, Gs, Gs, Ss, Gll^Fmw, Ss, Gll^Fmw, Wwg, Wog, Hhd^Fmw, Hhd^Fmw, Xue, Xue, Xue, Uue^Vu, Uue, Re^Edb, Re^Edb, Uue, Xue, Xue, Xue, Xue, Uue, Xue, Xue, Xue
Sm, Gll^Fp, Gll^Fp, Gll^Fp, Gll^Fp, Gll^Fdw, Re^Vhs, Gll^Fmw, Gll^Fdw, Gll^Fdw, Re, Gll^Fmw, Gll^Fmw, Gll^Fmw, Re^Vhs, Gll^Fmw, Gs, Re, Re, Sm, Gll^Fp, Gll^Fp, Wwg, Wwg, Hhd^Fmw, Gll^Fp, Xue, Xue, Xue, Xue, Uue^Edb, Re^Edb, Uue, Uue^Vu, Xue, Xue, Uue, Xue, Uue, Xue, Xue, Xue
Sm, Gll^Fmw, Sm, Gll^Fp, Ss, Gll^Fmw, Re, Gll^Fmw, Re, Re, Gll^Fmw, Gll^Fp, Gll^Fdw, Gll^Fp, Gll^Fmw, Gll^Fmw, Gs, Gll^Fmw, Gll^Fmw, Re, Re, Wwg, Gll^Fmw, Gll^Fmw, Re^Vc, Hhd, Hhd^Fmw, Xue, Xue, Xue, Uhe, Uue, Uue, Xue, Uue, Uue, Cer, Uue, Uue, Xue, Xue, Xue
Ss, Gll^Fmw, Sm^Edb, Sm^Edb, Gll^Fmw, Gll^Fdw, Gll^Fmw, Re, Gll^Fmw, Gll^Fp, Gll^Fmw, Gll^Fmw, Gll^Fp, Gll^Fp, Sm^Edb, Sm^Edb, Gll^Fmw, Gll^Fmw, Gll^Fp, Gll^Fp, Ss, Ss^Bw\r, Re, Gll^Fmw, Gll^Fmw, Gll^Fmw, Gll^Fmw, Hhd^Fmw, Xue, Uhe, Uue^Vu, Re, Uue, Uue, Re^Edb, Cer^Es, 6 Ker, Cer, Uue, Uhe, Xue, Xue
Ss, Sm, Ss, Sm^Edb, Gll^Fp, Gll^Fmw, Re^Vc, Re^Edb, Gll^Fmw, Gll^Fmw, Gll^Fmw, Gll^Fdw, Gll^Fmw, Gll^Fp, Sm^Edb, Sm^Edb, Sm^Edb, Ss, Gll^Fmw, Gll^Fmw, Ss, Ww, Ww, Re^Em, Re, Re, Re, Hhd^Fmw, Re, Re^Edb, Re^Edb, Re^Edb, Re^Edb, Re^Edb, Uue, Cer^Es, Cer, Cer^Es, Uue, Uhe, Uue^Vu, Xue
Gll^Fp, Gll^Fmw, Gll^Fmw, Ss, Gll^Fp, Gll^Fdw, Gll^Fdw, Re^Em, Gll^Fp, Re^Vhs, Gll^Fp, Gll^Fmw, Gll^Fmw, Gll^Fmw, Ss, Ss, Sm^Edb, Gll^Fp, Gll^Fmw, Gll^Fmw, Gll^Fmw, Gll^Fmw, Ww, Gll^Fp, Gll^Fmw, Gll^Fp, Gll^Fmw, Re, Re, Re^Edb, Uue, Re^Edb, Re^Edb, Re^Edb, Re^Edb, Uue, Uue, Uhe, Uhe, Uue, Uue, Uue
Gll^Fp, Gll^Fmw, Gll^Fmw, Gll^Fp, Gll^Fmw, Gll^Fmw, Re, Re, Re, Gll^Fmw, Re, Gll^Fp, Gll^Fmw, Gll^Fmw, Gll^Fmw, Gll^Fp, Gll^Fmw, Gll^Fp, Gll^Fmw, Gll^Fmw, Gll^Fp, Gll^Fmw, Gll^Fmw, Ww, Ww, Ww, Gll^Fmw, Gll^Fmw, Hhd^Fmw, Xue, Xue, Uue, Uue, Re^Edb, Re, Uue^Edb, Uue, Uhe, Uhe, Uue, Uhe, Uue
Gll^Fmw, Gll^Fmw, Gll^Fp, Gll^Fmw, Gs^Vhs, Re, Gs^Em, Gll^Fp, Re, Gll^Fp, Re, Gll^Fmw, Re^Vhs, Gll^Fmw, Gll^Fdw, Gll^Fmw, Gll^Fmw, Gll^Fdw, Gll^Em, Gll^Fp, Gll^Fp, Gll^Fmw, Gll^Fmw, Wog, Wog, Gll^Fp, Hhd, Gll^Fdw, Hhd, Xue, Xue, Xue, Xue, Uhe, Uue^Vu, Re, Re, Uue, Uhe, Uue^Vu, Uhe, Uue
Gs^Fp, Gll^Fp, Gll^Fp, Gll^Fp, Gll^Fp, Gs^Em, Gll^Fp, Gll^Fmw, Gll^Fdw, Re, Re, Gll^Fmw, Gll^Fdw, Gll^Fp, Gll^Fp, Gd^Fetd, Gll^Fp, Gll^Fmw, Gs^Em, Gs^Edb, Gll^Fmw, Gll^Fp, Gll^Fmw, Gll^Fp, Wog, Wog, Hhd^Fmw, Hhd^Fp, Hhd^Fp, Hhd^Fmw, Xue, Xue, Xue, Uhe, Uhe, Uue, Uue, Re, Uue, Uhe, Uhe, Uhe
Gs^Fp, Gll^Fp, Gll^Fdw, Gll^Fmw, Gll^Fmw, Gll^Fmw, Gll^Fp, Gll^Fp, Gll^Fmw, Gll^Fmw, Re, Gll^Fmw, Gll^Fp, Gll^Fp, Gll^Fp, Gll^Fmw, Gll^Fmw, Gll^Fmw, Gs, Gs, Gs, Gs, Gll^Fmw, Gll^Fmw, Wog, Wog, Gll^Fmw, Hhd^Fmw, Hhd^Fp, Hhd^Fmw, Hhd^Fp, Hhd, Xue, Xue, Xue, Uue, Uue, Uue, Uue, Uhe, Uue, Uhe
