Gg, Gg, Gg, Re, Gg, Gg, Gg, Gg, Gg, Gg, Gg, Gg, Gg, Gg, Gg, Gs^Fp, Gs^Fms, Ww, Ww, Gs^Fp, Gg, Gs^Fp, Gg, Gg, Gg, Gg, Gg, Gg, Gg, Gs^Fds, Gs^Fds, Gs^Fds, Gg, Gg, Gg, Gg, Gg, Gg, Gs^Fds, Gg, Gs^Fds, Gs^Fds
Gg, Gg, Gg, Re, Gg, Gg, Gg, Gg, Gg, Gg, Gg, Gg, Gg, Gg, Gg, Gs^Fp, Gs^Fp, Gs^Fp, Ww, Gs^Fms, Gg^Vh, Gs^Fp, Gg, Gg, Gg, Gg, Gg, Gs^Fds, Gg, Gs^Fds, Gs^Fds, Gs^Fds, Gg, Gg, Gg, Gg, Gg, Gg, Gs^Fds, Gg, Gs^Fds, Gs^Fds
Gg, Gg, Re, Re, Gg, Gg, Gg, Gg, Hh, Hh, Hh, Hh, Gg^Vh, Gg, Gg, Gs^Fms, Gs^Fms, Gs^Fp, Gs^Fms, Gs^Fp, Gs^Fms, Gs^Fms, Gs^Fms, Gg, Gg, Gg, Gg, Gg, Gg, Gg, Gg, Gg^Vh, Hh, Gg, Ce, Ce, 4 Ke, Ce, Gg, Gs^Fds, Gs^Fds, Gs^Fds
Gg, Gg, Re, Gg, Gg, 6 Gg, Gg, Gg, Gg, Hh, Gg, Hh, Gg, Gg, Gg, Gg, Gg, Gs^Fp, Gg, Gs^Fp, Gs^Fp, Gg, Gs^Fp, Gs^Fp, Gg, Gg, Gg, Gg, Gg, Gg, Gg, Gg, Hh, Gg, Gg, Ce, Ce, Ce, Gg, Gg^Vh, Gs^Fds, Gs^Fds
Gg, Gg, Re, Gg, Gg, Gg, Gg, Gg, Gg, Gg, Gg, Gg, Gg, Gg, Gg, Gg, Gg, Gg, Gg, Gg, Gg, Gg, Gg, Gs^Fp, Gg, Gg, Gg, Gg, Gg, Gg, Gg, Hh, Gg, Hh, Hh, Gg, Gg, Gg, Gg, Gg, Gg, Gg
Gg, Gg, Gg, Re, Hh, Hh, Gg, Gg, Gg, Gg, Gg, Gg, Gg, Gg, Gg, Gg, Gg, Gg, Hh, Gg, Gg, Gg, Gg, Gg, Gg, Hh, Hh, Gg, Hh, Gg, Gg, Gg, Gg, Hh, Gg, Gg, Gg, Gs^Fds, Gg, Gg, Gg, Gg
Gg, Gg, Gg^Vh, Re, Gg, Gg, Gg, Gg, Gg, Gg, Gg, Gg, Gg, Gg, Gg, Gg, Gg, Hh, Gg, Hh, Gg, Gg, Gg, Gg, Gg, Gs^Fds, Gg^Vh, Hh, Gg, Hh, Gg, Gg, Gg, Gg, Gg, Gg, Gg, Gg, Gg, Gg, Gg, Gg
Gg, Gg, Re, Re, Gg, Gg, Gg, Gg, Gg, Gg, Gg, Gg, Gg, Gg, Gg, Gg, Gg, Gg, Gg, Gg, Gg, Gg, Gg, Gg, Gs^Fds, Gs^Fds, Gs^Fds, Gs^Fds, Gg, Gs^Fds, Gg, Gg, Gg, Gg, Gg^Vh, Gg, Gg, Gg, Gg, Gg, Gg, Gg
Gg, Gg, Re, Gg, Gg, Gg, Gg, Gg, Gg, Gg, Gg, Gg, Gg, Gg, Gg, Gg, Gg, Gg, Gs^Fds, Gg, Gs^Fds, Gg, Gs^Fds, Gs^Fds, Gs^Fds, Gg, Gg, Gg, Gg, Gg, Gg, Gg, Gg, Gg, Gg, Gg, Gg, Gg, Gg^Vh, Gg, Gg, Gg
Gg, Gg, Gg, Re, Re, Gg, Gg, Gg, Gg, Gg, Gg, Gg, Gs^Fds, Gg^Vh, Gs^Fds, Gg, Gg, Gg, Gg, Gs^Fds, Gg, Gg^Vh, Gg, Gg^Vh, Gs^Fds, Gs^Fds, Gg, Gg, Gg, Gg, Gg, Gg, Gg, Gg, Hh, Gg, Gg, Gg, Gg, Gg, Gg, Gg
Gg, Gg, Gg, Gg, Re, Gg, Gg, Gg, Gg, Gg, Gg^Vh, Gg, Gs^Fds, Gs^Fds, Hh, Gg, Qxu, Gg, Qxu, Qxu, Qxe^Bsb|, Qxu, Qxu, Gg, Qxu, Gg, Gg, Gg, Gg, Gg, Gg, Gg, Hh, Hh, Gg^Vh, Hh, Gg, Gg, Hh, Hh, Gg, Gg
Gg, Gg, Gg, Gg, Gg, Re, Gg, Gg, Gg, Gg, Gg, Gs^Fds, Gg, Gg, Hh, Qxu, Mm^Xm, Qxu, Qxu, Qxu, Qxe^Bsb|, Qxu, Qxu, Qxu, Mm^Xm, Qxu, Hh, Hh, Gs^Fds, Gg, Gg, Gg, Gg, Hh, Hh, Gg, Hh, Gg, Gg^Vh, Hh, Gg, Gg
Gg, Gg, Gg, Gg, Gg, Re, Re, Gg, Gg, Gg, Gg, Hh, Hh, Hh, Mm, Mm^Xm, Ch, Mm, Mm, Kh, Rr, Kh, Mm, Mm, Ch, Mm^Xm, Mm, Hh, Gs^Fds, Gg, Gg, Gg, Gg, Gg, Gg, Gg, Gg, Gg, Gg, Hh, Gg, Gg
Gg, Gg, Gg, Gg, Gg, Gg, Re, Gg, Gg, Gg, Gg, Gg, Gg, Hh, Mm^Xm, Ch, Rr, Ch, Rr, Rr, Rr^Vhc, Rr, Rr, Ch, Rr, Ch, Mm^Xm, Hh, Hh, Gg, Gg, Gg, Gg, Gg, Gg, Gg, Gs^Fds, Gg, Gg, Gg, Gg, Gg
Hh, Hh, Hh, Gg, Gg, Gg, Re, Gg, Gg, Gg, Rr, Rr, Rr, Qxu, Mm^Xm, Ch, Ch, Ch, Rr, Mm, Mm, Mm, Rr, Ch, Ch, Ch, Mm^Xm, Qxu, Rr, Gg, Gg, Gg, Gg, Gg, Gg, Gs^Fds, Gg, Gs^Fds, Gg, Gg, Gg, Gg
Hh, Hh, Hh, Gg, Gg, Gg, Gg, Re, Rr, Rr, Gg, Hh, Qxu, Qxe^Bsb\, Rr, Mm, Rr, Rr, Ch, Ch, Ch, Ch, Ch, Rr, Rr, Mm, Rr, Qxe^Bsb/, Qxu, Rr, Hh, Gg, Gg, Gg, Gg, Gg, Gg, Gs^Fds, Gg, Gg, Gg, Gg
Gg, Gg, Gg, Gg, Gg, Gg, Gg, Gg^Vh, Re, Gg, Gg, Hh, Mm^Xm, Mm, Kh, Rr, Rr^Vhc, Mm, Mm, Mm^Xm, 3 Kh, Mm^Xm, Mm, Mm, Rr^Vhc, Rr, Kh, Mm, Mm^Xm, Hh, Rr, Rr, Rr, Re, Re, Gg, Gg, Gg, Gg, Gg, Gg, Gg
Gg, Gg, Gg, Gg, Re, Gg, Re, Re, Gg, Gg, Hh, Hh, Qxu, Mm, Rr, Rr, Rr, Mm, Ch, Mm^Xm, Ch, Mm^Xm, Ch, Mm, Rr, Rr, Rr, Mm, Qxu, Hh, Rr, Rr, Re, Re, Re, Re, Re, Gg^Vh, Hh, Gg, Gg, Gg
Gg, Gg, Re, Re, Gg, Re, Gg, Rr, Rr, Hh, Rr, Hh, Rr, Qxe^Bsb/, Mm^Xm, Mm, Ch, Rr, Rr, Ch, Mm, Ch, Rr, Rr, Ch, Mm, Mm^Xm, Qxe^Bsb\, Rr, Hh, Hh, Rr, Gg, Gg, Gg, Re, Re, Gg, Gg^Vh, Hh, Hh, Hh
Re, Re, Gg, Gg, Gg, Gg, Gg, Gg, Gg, Rr, Gg, Rr, Hh, Qxu, Mm^Xm, Ch, Rr, Ch, Rr, Mm, Rr^Vhc, Mm, Rr, Ch, Rr, Ch, Mm^Xm, Qxu, Hh, Rr, Rr, Rr, Gg, Gg, Gg, Re, Re, Re, Re, Gg, Gg, Gg
Gg, Gg, Gg, Gg, Gg, Gg, Gg, Gg, Gs^Fds, Gg, Hh, Hh, Hh, Qxu, Mm, Ch, Ch, Ch, Mm, Rr, Rr, Rr, Mm, Ch, Ch, Ch, Mm, Hh, Gg, Gg, Gg, Gs^Fds, Gg, Gg, Gg, Gg, Gs^Fds, Re, Re, Gg, Gg, Gg
Gg, Gg, Gg, Gg, Gg, Gg, Gg, Gs^Fds, Gg, Gs^Fds, Gg^Vh, Gs^Fds, Gg, Qxu, Hh, Mm^Xm, Mm^Xm, Mm, Qxu, Kh, Qxe^Bsb|, Kh, Qxu, Mm, Mm^Xm, Mm^Xm, Hh, Hh, Gs^Fds, Gg, Gg, Gg, Gg, Gg, Gg, Hh, Gs^Fds, Re, Re, Re, Gg, Gg
Gg, Gg, Gg, Gg, Gg, Gs^Fds, Gg, Gg, Gs^Fds, Gg, Gs^Fds, Gs^Fds, Gs^Fds, Gg, Gg, Hh, Hh, Hh, Qxu, Qxu, Gg^Bsb|, Qxu, Qxu, Qxu, Qxu, Qxu, Gs^Fds, Gs^Fds, Gs^Fds, Gg, Gg, Gg, Gg, Gg, Gg, Hh, Hh, Gs^Fds, Re, Re, Gg, Gg
Gg, Gg, Gg, Gg, Gg, Gs^Fds, Gs^Fds, Gg, Gs^Fds, Gg^Vh, Gs^Fds, Gs^Fds, Gs^Fds, Gs^Fds, Gg, Gg, Gg, Gg, Gg, Qxu, Rr, Qxu, Hh, Hh, Hh, Hh, Gg, Gg^Vh, Gg, Gg, Gg, Gg, Gg, Gg, Gg, Gg, Gg, Gg, Re, Re, Re, Re
Gg, Gg, Gg, Gg, Gg, Gg, Gg, Gg, Gg, Gs^Fds, Gg, Gg, Gs^Fds, Gg, Gg, Gg, Gg, Gg, Gg, Gg, Rr, Gg, Gg, Gg, Gg, Hh, Gg, Gg, Gg, Gg, Gg, Gg, Gg^Vh, Gg, Gg, Gg, Gg, Gg, Gg, Re, Re, Re
Gg, Gg, Gg, Gg, Hh, Hh, Gg, Gg, Gg, Gg, Gg, Gg, Gs^Fds, Gg, Gg, Gg^Vh, Gg, Gg, Gg, Rr, Gg, Gg, Gg, Gg, Gg, Hh, Gg, Gg, Gg, Gg, Gg, Gg, Gg, Gg, Gg, Gg, Gg, Gg, Gg, Gg, Gg, Gg
Gg, Gg, Gg, Gg, Gg, Hh, Gg, Gg, Gg, Gg, Gg, Gg, Gg, Gg, Gg, Gg, Gg, Gg, Gg, Rr, Gg, Gg, Gg, Gg, Gg, Gg, Gg, Gg, Gg, Gg, Gg, Gg, Gg, Gg, Gg, Gg, Gs^Fds, Gg, Gg, Gg, Gg, Gg
Gg, Gg, Gg, Gg, Re^Gvs, Gg, Gg, Gg, Gg, Gg, Gg, Gg, Gg, Gg, Gg, Gg, Gg, Gg, Re, Re, Gg, Gg, Gg, Gg, Gg, Gg, Gg, Gg, Gg, Gg, Gg, Gg, Gg, Gg, Gs^Fds, Gs^Fds, Gg, Gg, Gg, Gg, Gg, Gg
Gg, Gg, Gg, Re^Gvs, Re^Gvs, Gg, Gg, Gg^Vh, Gg, Gg, Gg, Gg, Gg, Gg, Gg, Gg, Gg, Re, Gg, Gg, Gg, Gg, Gg, Gg, Gg, Gg, Re^Gvs, Gg, Gg, Gg, Gg, Gg, Gg, Gg, Gs^Fds, Gg, Gg^Vh, Gg, Gg, Gg, Gg, Gg
Gg, Gg, Gg, Re^Gvs, Gg, Gg, Gg, Gg, Gg, Gg, Gg, Gg, Gg, Gg, Gg, Gg, Gg, Re, Gg, Gs^Fds, Gs^Fds, Gg, Gg, Gg, Gg^Vh, Re^Gvs, Re^Gvs, Gg, Gg, Gg, Gg, Gg, Gg, Gg, Gg, Gg, Gg, Gg, Gg, Gg, Gg, Gg
Gg, Gg, Gg, Gg, Gg, Gg, Gg, Gg, Gg, Gg, Gg, Gg, Gg, Gg, Gg^Vh, Gg, Gg, Re, Re, Gg, Gs^Fds, Gs^Fds, Gg, Gs^Fds, Gg, Re^Gvs, Gg, Gg, Gg, Gg, Gg, Gg, Gg, Gg, Gg, Gg, Gg, Gg, Gg, Gg, Gg, Gg
Gs^Fds, Gg, Gg, Gg, Re^Gvs, Gg, Re^Gvs, Gg, Re^Gvs, Gg, Gg, Gg, Gg, Gg, Gg, Gg, Gg, Gg, Re, Gg, Gs^Fds, Gs^Fds, Gs^Fds, Gs^Fds, Gg, Gg, Gg, Gg, Gg, Gg, Gg, Gg, Gg, Gg, Gg, Gg, Gg, Gg, Gg^Vh, Gg, Gg, Gg
Gs^Fds, Gs^Fds, Gg, Re^Gvs, Re^Gvs, Re^Gvs, Re^Gvs, Re^Gvs, Re^Gvs, Re^Gvs, Gg, Gg, Gg, Gg, Gg, Gg, Gg, Gg, Re, Gg, Gg, Gg, Gs^Fds, Gs^Fds, Gs^Fds, Hh, Gg, Gg, Gg, Gg, Gg, Gg, Gg, Gg, Gg^Vh, Gg, Gg, Gg, Gg, Gg, Gg, Gg
Gs^Fds, Gs^Fds, Gg, Gg, Gg, Gg, Gg, Gg, Gg, Gg, Gg, Gg, Gg, Gg, Gg, Gg, Gg, Gg, Re, Gg, Gg, Gg, Gg, Gg, Gg, Hh, Gg, Gg, Gg, Gg, Gs^Fds, Gs^Fds, Gs^Fds, Gg, Gg, Gg, Re^Gvs, Re^Gvs, Re^Gvs, Gg, Gg, Gg
Gs^Fds, Gs^Fds, Gg, Gg, Gg, Gg, Gg, Gg, Gs^Fds, Gg, Gs^Fds, Gg, Gg, Gg, Gg, Gg, Gg, Gg, Gg, Re, Re, Gg, Gg, Gg, Gg, Gg, Gg, Gg, Gg, Gs^Fds, Gs^Fds, Gs^Fds, Gs^Fds, Gg, Gg, Gg, Re^Gvs, Re^Gvs, Gg, Gg, Gg, Gg
Gs^Fds, Gs^Fds, Gg, Gg, Gg, Gg, Gs^Fds, Gs^Fds, Gs^Fds, Gs^Fds, Hh, Gs^Fds, Gs^Fds, Gg, Gg, Gg, Gg, Gg, Gg, Gg, Gg, Re, Re, Gg, Gg, Gg, Gg, Gg, Gg, Gs^Fds, Gg, Gg, Gs^Fds, Gs^Fds, Gg, Re^Gvs, Re^Gvs, Re^Gvs, Gg, Gg, Gg, Gg
Gg, Gg, Gg, Gg, Gg^Vh, Gs^Fds, Hh^Fds, Hh^Fds, Gs^Fds, Gs^Fds, Hh, Gs^Fds, Gs^Fds, Gg, Gs^Fds, Gg, Gs^Fds, Gg, Gg, Gg, Gg, Gg, Re, Gg, Gg, Gg, Gg, Gg, Gg, Gs^Fds, Gg^Vh, Gg, Gs^Fds, Gg, Gg, Gg, Gg, Gg, Gg, Gg, Gs^Fds, Gs^Fms
Gg, Gg, Gg, Gg, Gs^Fds, Hh, Hh^Fds, Hh^Fds, Hh, Gg^Vh, Gs^Fds, Hh, Gs^Fds, Gs^Fds, Gs^Fds, Gs^Fds, Gs^Fds, Gg, Gs^Fds, Gs^Fds, Gs^Fds, Gg, Re, Gg, Gg, Gg, Ce, Gg, Gg, Gs^Fds, Gs^Fds, Gs^Fds, Gg, Gg, Gg, Gg, Gg, Gg, Gg, Gs^Fds, Gs^Fds, Gs^Fms
Hh, Hh, Hh^Fds, Gs^Fds, Hh^Fds, Gs^Fds, Gs^Fds, Hh, Gs^Fds, Gs^Fds, Hh, Gs^Fds, Gs^Fds, Gs^Fds, Gs^Fds, Gg, 2 Gg, Gs^Fds, Gs^Fds, Gs^Fds, Gg, Gs^Fds, Re, Gg, Gs^Fds, Gs^Fds, 5 Ke, Ce, Gg, Gg, Gg, Gg, Gg, Gg, Gg, Gg, Gg, Gg, Gs^Fds, Gs^Fms, Gg, Gg
Gs^Fds, Hh^Fds, Hh^Fds, Hh, Hh^Fds, Hh^Fds, Gs^Fds, Gs^Fds, Hh^Fds, Hh^Fds, Hh^Fds, Gs^Fds, Gg, Gs^Fds, Ce, Ce, Ce, 1 Ke, Ce, Gg, Ce, Gg^Vh, Re, Gs^Fds, Gs^Fds, Ce, Ce, Ce, Ce, Gg, Gg, Gg, Gs^Fds, Gs^Fds, Gg, Gs^Fms, Gs^Fms, Gg, Gs^Fms, Gs^Fms, Gs^Fp, Gs^Fp
Gs^Fds, Gs^Fds, Hh^Fds, Hh^Fds, Hh^Fds, Hh, Hh, Hh^Fds, Hh^Fds, Hh^Fds, Hh^Fds, Gg, Gs^Fds, Gs^Vh, Gs^Fds, Gg, Gs^Fds, Gs^Fds, Gs^Fds, Ce, Gs^Fds, Gs^Fds, Re, Gs^Fds, Gg, Gg, Gg, Gg, Gg, Gg, Gg, Gs^Fds, Gg, Gg, Gg, Gg, Gs^Fds, Gs^Fms, Gs^Fds, Gs^Fms, Gs^Fms, Gs^Fp
Gs^Fds, Gs^Fds, Gs^Fds, Hh, Gs^Fds, Hh, Hh, Hh^Fds, Hh^Fds, Hh^Fds, Hh^Fds, Gs^Fds, Gs^Fds, Gs^Fds, Gs^Fds, Gs^Fds, Gs^Fds, Gs^Fds, Gs^Fds, Gs^Fds, Gs^Fds, Gs^Fds, Re, Gs^Fds, Gs^Fds, Gg, Gg, Gg, Gg, Gg, Gg, Gg, Gg, Gg, Gg, Gg, Gs^Fds, Gs^Fds, Gs^Fms, Gs^Fms, Gs^Fms, Gs^Fp
