Gg, Gg, Gg, Gg, Gs, Gs, Gs, Gs, Gs, Rr, Re, Re, Re, Hh, Hh, Hh, Gs^Fms, Gs^Fms, Gs^Fms, Gs^Fms, Gs^Fms, Gs^Fms, Gs^Fds, Hh, Gg, Gg, Gs^Fds, Gs^Fms, Ww, Ww, Gs^Fp, Gs^Fp
Gg, Gg, Gg, Gg, Re^Gvs, Gs, Gs, Gs, Gs, Rr, Ce, Ce, Ce, Re, Gs^Fmw, Gs^Fms, Gs^Fms, Gs^Fds, Gs^Fms, Gs^Fms, Gs^Fms, Gs^Fds, Gs^Fms, Gs^Fms, Gg^Efm, Gs^Fms, Gs^Fms, Gs^Fms, Ww, Gs^Fms, Gs^Fms, Gs^Fds
Gg, Gg^Efm, Gg, Re^Gvs, Re^Gvs, Re^Gvs, Gs, Ce, Re^Vh, Rr, Ce, 3 Ket, Ce, Re, Re^Vh, Ce, Gs, Gs, Gs, Gs^Fms, Gs^Fms, Gs^Fmw, Gs^Vh, Gg, Gs^Fms, Gs^Fms, Gs^Fms, Gs^Fms, Ww, Gs^Fms, Gs^Fms, Gs^Fds
Gg, Gg, Gg, Gg, Gg, Gs, Re, Ce, Re, Rr, Rr, Ce, Re, Re^Es, Re, Ce, Gs, Gs^Fms, Gs, Gs^Fms, Gg^Efm, Gs^Fms, Gs^Fms, Gg, Gs^Fmw, Gs^Fmw, Gs^Fms, Ww, Gs^Fms, Gs^Fmw, Gs^Fms, Gs^Fms
Gg, Gg, Re^Gvs, Re^Gvs, Re, Re^Es, Gg, Re, Gs^Fms, Re, Re^Vh, Rr, Re^Vh, Re, Gg, Gs, Gs^Fms, Gs^Fms, Gs^Fms, Gg, Gs^Fms, Gs, Gs, Gg, Gs, Gs, Ww, Ww, Gs^Fms, Gs^Fmw, Gs^Fms, Gs^Fds
Gg, Re^Gvs, Re^Gvs, Re^Gvs, Gs^Vh, Gs, Gs^Fms, Gg, Gs^Fp, Ce, Ce, Rp, Ce, Ce, Gg, Gs, Gs^Fms, Gs^Fms, Gs^Fp, Gs^Fp, Gs^Fmw, Gs, Gs^Fms, Gs^Fms, Ww, Ww, Gs^Fms, Gs^Fms, Gs^Fmw, Gs^Fms, Gs^Fdw, Gs^Fms
Re, Gs, Re^Gvs, Re^Gvs, Gs, Gs, Gs^Fms, Gs^Fms, Gs^Fms, Gs^Fms, Rp, Rp, Gg, Gs^Fms, Gs^Fms, Gs, Gg, Gs^Fmw, Gs^Fmw, Gs^Fms, Gs^Fms, Gs, Gs, Gs^Fms, Wwf, Gs, Gg, Gs^Fms, Gs^Fds, Gs^Vht, Gs^Fms, Gs^Fms
Gs, Gs, Gg, Gg, Re^Gvs, Gs, Gs, Gs, Gs^Fms, Gg, Rp, Gg, Gs^Fms, Gs^Fms, Gs^Fms, Gs^Fms, Gg, Gs^Fms, Gs^Fmw, Gs^Vh, Gs, Gs, Ss, Wwf, Gs, Gs, Gg, Gs^Fms, Gg, Gg, Gg, Gg
Gg, Gs, Gg, Re^Gvs, Re^Gvs, Gs^Vh, Re^Gvs, Gs, Gg, Gg, Rr, Gs^Fms, Gs^Fms, Gs^Fms, Gs^Fms, Gs^Fms, Gs^Fms, Gg, Gg, Gg^Efm, Gs^Fms, Gs^Fp, Ss, Wwf, Gs^Fms, Gs, Gs^Fds, Gg, Gg^Efm, Gs^Fp, Gs^Fms, Gs^Fms
Gg, Gg, Gg^Efm, Gg, Re^Gvs, Re^Gvs, Gs^Fms, Gs, Rr, Rr, Gs^Vh, Gs^Fms, Gs^Fds, Gs^Fp, Gs^Fms, Gs^Fms, Ss, Gs^Fmw, Gg, Gs^Fms, Gs^Fms, Gs^Fms, Ww, Ww, Gs^Fms, Gs, Gs^Fms, Gs^Fmw, Gs^Fms, Gs^Fms, Gs^Fms, Gs^Fms
Gg, Gg, Gg, Gg, Gg, Gs^Fms, Gs, Gs, Rr, Gs^Fdw, Gs^Fds, Gs^Fds, Gs^Fms, Gs^Fms, Gs^Fds, Gs^Fms, Ss, Ss, Gs, Gs^Fms, Gs^Fds, Gs^Fdw, Ww, Gs^Fms, Gs^Fms, Gs, Gs, Gs^Fms, Gs^Fds, Gs^Fmw, Gs^Fms, Gs^Fms
Gg, Gg, Gs, Gg, Gg, Gg, Rr, Rr, Gs^Fmw, Gs, Gs, Gs^Fms, Gs^Fms, Gs^Fds, Gs^Fms, Gs, Gs, Gs, Gs^Fms, Gs, Ss, Ss, Ww, Ss, Ss, Gs, Ss, Ss, Gs^Fms, Gs^Fms, Gs^Fp, Gs^Fms
Gs, Gg, Gs, Gs^Fms, Gs^Fms, Gs^Fms, Rr, Gs^Fds, Gs^Fmw, Gs^Fms, Gs^Fms, Gg, Gs^Fms, Gs^Fms, Gs^Fms, Gs, Gs^Vh, Gs^Fms, Gs^Fms, Gs, Ss, Ww, Ss, Ss, Ss, Ss^Bw|r, Ss, Gs^Fms, Gs^Fms, Gs^Fms, Gs^Fms, Gs^Fms
Gs, Gs, Gs, Gs^Fms, Gs^Fms, Rp, Gs^Fms, Gs^Fms, Gs^Fms, Gs^Fms, Gs^Vh, Gg^Efm, Gg, Gs^Fms, Gs, Gs, Gs^Fms, Gs^Fms, Ss, Ss^Bw|r, Ss^Bw\r, Ss, Ss, Gs^Fms, Gs^Fms, Gs, Ss, Gs^Fms, Gs^Fms, Gs^Fdw, Gg, Gs^Fmw
Gg, Gs, Gg, Gs^Fms, Gs, Rp, Gs^Fms, Gs^Fms, Gs^Fms, Gs^Fmw, Gs^Fms, Gg, Gs^Fmw, Gg, Gg, Gs^Fdw, Gs^Fds, Gs^Fms, Ss, Ss, Re^Vht, Gs, Gs, Gs^Fms, Gs^Fms, Gs, Gs^Vhs, Gs^Fp, Gs^Fms, Gs^Fms, Gg, Gs^Fmw
Gg, Gs, Gg, Gg, Gs, Rp, Gs, Gs, Gs, Gs^Fdw, Gs^Fms, Gs^Fmw, Gs^Fms, Gs^Fdw, Gs^Fmw, Gs, Gs, Gs, Ww, Ss, Gs^Fms, Gs^Fms, Gg^Efm, Gs^Fmw, Gs^Fms, Gs, Gs^Fms, Gs^Fms, Gs^Fms, Gg, Gs^Fms, Gg
Gg, Gg, Gs^Vh, Gg, Rr, Rr, Gs^Fms, Gs^Fms, Gs^Fms, Gs, Gs^Fms, Gs^Fms, Gs^Fms, Gs^Fds, Gs^Fds, Gs^Fms, Gs^Fms, Gs^Fms, Ww, Ss, Gs^Fms, Gs^Fms, Gg, Gg, Gg, Gg, Gs, Gs^Fds, Gg, Gg, Gs^Fmw, Gs^Fms
Gg, Gg, Gg, Gg, Rr, Gs^Fmw, Gs^Fms, Gs^Fp, Gs^Fms, Gs, Gg^Efm, Gs^Fds, Gg, Gs^Fds, Gs^Fms, Gs^Fms, Ww, Ww, Gs^Vhs, Gs^Fms, Gs^Fms, Gs^Fms, Gs^Fms, Gs^Fp, Gs^Fms, Gs^Fms, Gs^Fms, Gs, Gg^Efm, Gs^Fms, Gs^Fp, Gs^Fms
Gs, Gg, Gs, Gg, Rp, Gg, Gs^Fds, Gs^Fms, Gs^Fms, Gs^Fms, Gs^Vh, Gg, Gs^Fdw, Gs, Gs, Gs, Wwf, Wwf, Gs, Gs, Gs^Fms, Gs^Fms, Gs^Vht, Gs^Fms, Gs^Fds, Gs^Fmw, Gs^Fms, Gs, Gs^Fms, Gs^Fds, Gs^Fms, Gs^Fms
Gs, Gs, Gs^Efm, Gg, Rp, Gg, Gs^Fms, Gs^Fds, Gs^Fds, Gs^Fds, Gs^Fmw, Gs^Fmw, Ss, Ss, Ww, Ww, Ww, Gs^Fms, Gs^Fms, Gs, Gs^Fms, Gs^Fds, Gs^Fms, Gs^Fms, Gs^Fms, Gs^Fms, Gs, Gs, Ce, Gs^Fms, Gs^Fms, Gs^Fms
Gg, Gg, Gs^Fms, Gg, Rp, Gs^Fms, Gs^Fms, Gs^Fms, Gs^Fms, Gs^Fdw, Gs^Fms, Ss, Ss, Ww, Ww, Ww, Gs^Fms, Gs^Fp, Gg, Gs, Gs, Gs^Fds, Gs^Fms, Gs, Re^Es, Re^Es, Rb, Ce, 1 Ke, Gs^Fms, Gs^Fds, Gs^Fds
Gg, Gg, Gs^Fms, Gg, Rr, Gs^Fms, Gs, Gs^Fms, Gs, Gs^Fms, Gs^Fms, Gs^Fms, Ss, Ww, Ww, Ww, Gs^Fms, Gg, Gs^Fms, Gs^Fms, Gs^Fms, Gs, Gg, Gs, Re, Re^Ecf, Rb, Ce, 2 Ke, Gs, Gs, Gs
Gs^Fms, Gs^Fms, Gs^Fms, Gs^Fms, Rp, Gs, Gs^Fms, Gs, Gs^Fms, Gs, Gs^Fms, Gs^Fds, Gs, Ww, Gs, Ss, Gs^Fms, Gg, Gs^Fmw, Gs^Fms, Gs^Fms, Gs^Fms, Gg, Gs^Fms, Gs^Fds, Re^Es, Rb, Ce, Ce, Gs^Fms, Gs^Fms, Gs^Fds
Gs^Fms, Gs^Fms, Gg, Rp, Gs^Fms, Gs, Gs^Fds, Gs^Fms, Gs^Fms, Gs, Gg, Gg, Gs^Fp, Gs, Wwf, Ss^Bw\, Gs, Gs, Gs^Fms, Gs^Fds, Gs^Fms, Gs^Fms, Gg, Gs^Fds, Gs^Fms, Gs^Vc, Gs^Fms, Rb, Gs^Fms, Gs^Fms, Gs^Fds, Gs^Fms
Gs^Fms, Gs^Fms, Gg, Rr, Gs^Fms, Gs^Fms, Gs^Fms, Gs^Fdw, Gs^Fms, Gs^Fms, Gs^Fms, Gs^Fds, Gs^Fms, Gs^Fp, Wwf, Gs, Gs^Fmw, Gs^Vc, Gs^Fmw, Gs^Fms, Gs^Fms, Gg^Efm, Gg, Gs^Fms, Gs, Gs^Fms, Gs^Fms, Gs, Gs^Fms, Gs^Fdw, Gs^Fms, Gs^Fms
Gg, Gg, Gg, Rr, Gs^Fms, Gs^Fms, Gs^Fms, Gs^Fms, Gs^Fms, Gs^Fms, Gs^Fms, Gs^Fms, Gs^Vc, Gs^Fms, Wwf, Gs, Gs^Fms, Gs^Fms, Gs^Fmw, Gs^Fdw, Gs^Fms, Gs^Fms, Gs^Fdw, Gs, Gs^Fp, Gs^Fms, Gg, Gs, Gs^Fms, Gs^Fms, Gs^Fds, Gs^Fms
Gg, Gg, Gg, Rr, Gs^Fms, Gs^Fms, Gs, Gs^Fms, Gs^Fms, Gs^Fms, Gs^Fms, Gs^Fdw, Gs^Fms, Gs, Gs^Fms, Wwf, Ww, Gs^Fds, Gs^Fms, Gs^Fms, Gs^Fms, Gs^Fms, Gs^Fds, Gs, Gs, Gs^Fms, Gg, Gs^Fms, Gs^Fms, Gs^Fms, Gs^Fms, Gs^Fms
Gg, Gs, Gs, Rr, Rr, Gs, Gs, Gs^Fms, Gs, Gs^Fms, Gs, Gs^Fms, Gs^Fms, Gg, Gs, Gs^Fds, Ww, Gs^Fmw, Gs^Fms, Gs^Fms, Gs^Fms, Gs^Fms, Gs^Fdw, Gs^Fms, Gs^Fms, Gs, Gg, Gg^Efm, Gs^Fp, Gs^Fms, Gs^Fds, Gs^Fms
Gg, Gs, Gs, Gs, Rp, Gs^Fms, Gs^Fms, Gs, Gs^Fms, Gs, Gs^Fms, Gg, Gg, Gg, Gs^Fms, Gs^Fmw, Gs^Fms, Ww, Ww, Gs^Fms, Gs^Fms, Gs^Fdw, Gs^Fms, Gs^Fms, Gs^Fms, Gs^Fds, Gs, Gs^Fms, Gs^Fds, Gs^Fms, Gs^Fms, Gs^Fms
Gs, Gs, Gg, Gs, Rr, Gg, Gs^Fms, Gs^Fms, Gs^Fms, Gs^Fms, Gs^Fmw, Gg^Efm, Gs^Fms, Gs^Fms, Gs^Fms, Gs^Fms, Gs^Fdw, Gs^Fms, Ww, Gs^Fms, Gs^Fms, Gs^Fms, Gs^Fds, Gs^Vht, Gs, Gs, Gs, Gs^Fms, Gs^Fp, Gs^Fms, Gs^Fds, Gs^Fms
Gs, Gg, Gg, Gg, Rr, Gs^Fms, Gg^Efm, Gg, Gg, Gs^Fmw, Gs^Fmw, Gg, Gg, Gs^Vht, Gs^Fms, Gs^Fms, Gs^Fms, Ss, Ww^Ewl, Ww, Ss, Gs^Fms, Gs^Fms, Gs^Fms, Gs^Fmw, Gs, Gs^Fms, Gs, Gs^Vc, Gs^Fms, Gs^Fms, Gs^Fms
Gs, Gg, Gg, Gg, Rr, Gg, Gs^Fms, Gs^Fms, Gs^Fms, Gs, Gs^Fms, Gs^Fms, Gs, Gs, Gs^Fms, Gs^Fms, Gs^Fms, Ss, Ss, Ww, Ww, Gs^Fms, Gs^Fms, Gs^Fds, Gg, Gg, Gs^Fms, Gs^Fds, Gs, Gs^Fds, Gs^Fms, Gs^Fms
Gs, Gg^Efm, Gg, Gg, Rr, Gs^Fms, Gs^Fms, Gs^Fms, Gs^Fms, Gs, Gs, Gs, Gg, Gs^Fms, Gs, Gs^Fms, Gs^Fms, Gs^Fms, Gs^Fms, Ww, Gs^Fdw, Gs^Fms, Gg, Gg, Gs^Fp, Gs^Fms, Gs^Fms, Gs, Gs, Gs^Fms, Gs^Fds, Gs^Fms
Gg, Gs, Gg, Gg, Rr, Gs^Fms, Gs^Fds, Gs^Fms, Gs^Fms, Gs^Fms, Gs^Fms, Gs, Gs^Fms, Gg^Efm, Gs^Vc, Gs, Gs, Gs^Fms, Gs, Ww, Gs^Fms, Gs^Fms, Gs^Fms, Gg, Gg, Gs^Fmw, Gs^Fms, Gs^Fdw, Gs, Gs^Fms, Gs^Fms, Gs^Fms
Gg, Gs, Gg, Gg, Rr, Gs^Fms, Gs^Fms, Gs^Fms, Gs^Fmw, Gs^Fms, Gs^Fms, Gs^Fms, Gs^Fds, Gs^Fds, Gs^Fms, Gs^Fms, Gs^Fms, Gs, Gs^Fms, Ww^Bw\, Gs, Gs, Gg, Gg, Gs^Fms, Gs, Gs^Fds, Gs, Gs^Fms, Gs^Fmw, Gs^Fms, Gs^Fp
Gg, Gs, Gg, Rr, Gs^Fms, Gs^Fms, Gs^Fms, Gs^Fds, Gs^Fms, Gs^Fms, Gs^Fp, Gs^Fp, Gs^Fms, Gs^Fms, Gs^Fms, Gs^Fms, Gs^Fms, Gs^Fms, Ww, Ww, Gs^Fms, Gs, Gs^Fms, Gs^Fms, Gs^Fms, Gs, Gs^Vht, Gg, Gg, Gs^Fms, Gs^Fp, Gs^Fms
Gg, Gg, Gg, Rr, Gs^Fms, Gs^Fms, Gs^Fms, Gs^Fms, Gs^Fms, Gs^Fms, Gs^Fp, Gs^Fms, Ss^Fp, Gs^Fms, Gs^Fms, Gs^Fms, Gs^Fp, Ww, Gs^Fp, Gs^Fms, Gs^Fdw, Gs^Fms, Gs^Fms, Gs^Fms, Gs^Fms, Gs^Fms, Gs^Fms, Gg, Gs^Fms, Gs^Fmw, Gs^Fms, Gs^Fms
Gg, Gg, Rp, Rp, Gs^Fms, Gs^Fms, Gs^Fms, Gs^Fmw, Gs^Fms, Gs^Fp, Gs^Fp, Gs^Fp, Ss, Ss, Ss, Gs^Fms, Gs^Fp, Ww, Ww, Gs^Fms, Gs^Fms, Gs^Fp, Gs^Fms, Gs^Fms, Gs^Fms, Gs^Fp, Gs^Fms, Gg^Efm, Gs^Fms, Gs^Fms, Gs^Fms, Gs^Fp
Gg, Gs, Rr, Gg, Gg^Efm, Gs^Fms, Gs^Fms, Gs^Fms, Gs^Fms, Gs^Fp, Ss, Ss, Ss, Gs^Fp, Ss, Ss, Ss, Ss, Ww, Ww, Gs^Fp, Gs^Fp, Gs^Fp, Ss, Ss, Gs^Fms, Gs^Fms, Gll^Fp, Gll^Fp, Gll^Fp, Gll^Fp, Gs^Fms
Gs, Gs, Rr, Gg, Gg, Gs^Fms, Gs^Fms, Gs^Fms, Gs^Fms, Gs^Fms, Ss, Gs^Fp, Gs^Fp, Ss, Ss, Ss, Gs^Fp, Ww, Ww, Ss, Ss, Ss, Ss, Gs^Fp, Ss, Gs^Fms, Gs^Fp, Gs^Fms, Gll^Fp, Gll^Fp, Gll^Fp, Gll^Fp
Gs, Gs, Rr, Gg, Gg, Gs^Fms, Gg, Gs^Fms, Gll^Fp, Gs^Fms, Ss, Ss, Gs^Fp, Ss, Ss, Gs^Fp, Gs^Fp, Ss, Ww, Ss, Ww, Ww, Ww, Ww, Gs^Fp, Gs^Fp, Gs^Fp, Ss, Gs^Fp, Ss, Ss, Gll^Fp
Gg, Gg, 4 Rr, Gg, Gg, Gg, Gg, Gs^Fms, Gll^Fp, Gs^Fms, Gll^Fp, Ss, Ss, Gll^Fp, Ss, Ss, Ss, Ss, Ss, Ss, Ss, Ww, Ww, Ss, Ss, Gs^Fp, Gll^Fp, Gll^Fp, Gll^Fp, Gs^Fp, Gll^Fp, Gll^Fp
Gg, Gg, Rr, Gg, Gg, Gg, Gs^Fms, Gs^Fms, Gs^Fms, Gll^Fp, Gll^Fp, Ss, Gs^Fms, Ss, Gs^Fms, Ss, Gs^Fms, Ss, Gs^Fms, Ss, Ss, Ww, Ww, Ww, Ww, Ss, Ss, Gll^Fp, Gll^Fp, Gll^Fp, Gll^Fp, Gll^Fp
