Rr, Gd, Gs, Gs, Gs, Gs, Gs, Gs, Gll^Fmf, Gg, Gll^Fmf, Gs, Gs, Gs, Gs, Gs, Gs, Gs, Gs, Gs, Gs, Gs^Es, Gd, Gs, Gs, Gs, Gs, Gs, Gs, Gs, Gs, Gs, Gs, Gll^Fmf, Gs, Gd, Gd, Gd, Gs, Gs, Gs, Gs
Gs, Rr, Rr, Gd, Gs, Gs, Gs, Gll^Fmf, Gs, Gll^Fmf, Gs, Gs, Gll^Fmf, Gs, Gd, Gd, Gs^Es, Gs, Gs, Gs, Gs, Gs, Gs, Gs, Gs, Gs, Gd, Gs, Gs, Gd, Gll^Fmf, Gs, Gll^Fmf, Gll^Fmf, Gd, Gs, Gs, Gd, Gs, Gs, Gs, Gs
Gs, Gs, Gs, Rr, Rr, Rr, Rr, Gd, Gs, Gd, Gs, Gs, Gll^Fmf, Gs, Gll^Fmf, Gll^Fmf, Gs, Gd, Gs^Es, Gs, Hhd, Gd, Gs, Gs, Gs, Gs^Es, Gd, Gs, Gll^Fmf, Gs, Gll^Fmf, Gll^Fmf, Gll^Fmf, Gs, Gs, Gs, Gs, Gd, Gs, Gs, Gs, Gs
Gs, Gs, Gs, Gs, Gs^Es, 6 Gs, Gs, Rr, Rr, Rr, Rr, Gs, Gll^Fmf, Gll^Fmf, Gll^Fmf, Gll^Fmf, Gll^Fmf, Gs, Gs, Hhd, Gs, Gs^Es, Hhd, Gs, Gs, Gs, Gs, Gs, Gll^Fmf, Gll^Fmf, Gs^Es, Gll^Fmf, Gll^Fmf, Gll^Fmf, Ce, Ce, 4 Ke, Gd, Gs, Gs, Gs, Gs
Gs, Gs, Gs, Gs, Gs, Gs, Gs, Gs, Gs, Gs, Gs, Rr, Rr, Gll^Fmf, Gs, Gll^Fmf, Gll^Fmf, Gs, Hhd, Hhd, Gs, Gs, Hhd, Gs, Gs, Gs, Gs, Gs, Gs, Gs, Gs, Gll^Fmf, Gs, Ce, Gd, Ce, Ce, Gs, Gs, Gs, Hhd, Gs
Gs, Gs, Gs, Gs, Gd, Gs, Gs, Gs, Gll^Fmf, Gs, Gd, Gs, Gs, Rr, Rr, Gs, Gll^Fmf, Gd, Gs, Hhd, Hhd, Hhd, Hhd, Gd, Gs, Ww, Ww, Gs, Gd, Gs, Rb^Gvs, Gs, Gs, Gs, Gd, Ce, Hhd, Hhd, Gs, Gs, Hhd, Hhd
Gs, Gs, Gs, Gd, Gs, Hhd, Gs, Gd, Gll^Fmf, Gs, Gll^Fmf, Gs, Gs, Gs, Gs, Rr, Gs, Gs, Gs, Gs, Hhd, Hhd, Hhd, Gd, Gs, Ww, Ww, Gs, Rb^Gvs, Rb^Gvs, Rb^Gvs, Rb^Gvs, Rb^Gvs, Gs, Gd, Hhd, Hhd, Hhd, Hhd, Hhd, Hhd, Hhd
Gs, Gs, Gd, Gs^Vh, Gs, Gs, Hhd, Hhd, Gll^Fmf, Gll^Fmf, Gll^Fmf, Gs, Gs, Gs, Gs, Rr, Rr, Gs, Gs, Gs, Gll^Fmf, Gll^Fmf, Gs, Hhd, Gs, Gs, Gs, Gs, Gs, Rb^Gvs, Rb^Gvs, Rb^Gvs, Rb^Gvs, Gs, Gs, Hhd, Gs, Gs, Gs, Hhd, Hhd, Hhd
Gs, Gs, Gs, Gs, Gs, Hhd, Hhd, Hhd, Hhd, Hhd, Gs, Gll^Fmf, Gs^Es, Gs, Hhd, Gs, Gs, Rr, Rr, Gs, Gs, Gll^Fmf, Gll^Fmf, Gs, Gs, Gs, Rb^Gvs, Gd, Gs^Vh, Gll^Fmf, Hhd, Rb^Gvs, Gs, Gs, Gs, Gs, Gs, Gd, Gs^Es, Gs, Hhd, Hhd
Gs, Gs, Gs, Gs, Gs, Hhd, Gs, Gs, Hhd, Hhd, Gs, Gs, Gs, Gs^Es, Hhd, Gs, Rb^Gvs, Gs, Gd, Rr, Rr, Gd, Gs, Gs^Vh, Rb^Gvs, Rb^Gvs, Rb^Gvs, Gd, Gll^Fmf, Gll^Fmf, Hhd, Hhd, Hhd, Gs, Gs, Gd, Gd, Gs, Gs, Gs, Hhd, Hhd
Hhd, Gd, Gs, Gs, Gs, Gs^Es, Gll^Fmf, Gs, Gs, Hhd, Gs, Gs, Gs, Hhd, Hhd, Hhd, Hhd, Rb^Gvs, Rb^Gvs, Gs, Rr, Gs, Gs, Rb^Gvs, Gs, Rb^Gvs, Rb^Gvs, Rb^Gvs, Gs, Hhd, Hhd, Hhd, Hhd, Gs, Gs, Gs, Gd, Gs, Gs, Hhd, Gs^Es, Gs^Es
Hhd, Gs, Gs, Gs, Gs, Gs, Gll^Fmf, Gd, Gs, Gs, Hh, Gs, Gll^Fmf, Gs, Gs, Gs^Vh, Rb^Gvs, Rb^Gvs, Rb^Gvs, Gd, Rr, Gs, Gd, Gs, Gs^Vh, Gs, Gs, Hh, Gs, Gs, Gs^Vh, Hhd, Gs, Gs, Gs, Gs, Gs, Gs, Gs, Gs, Gs, Gs
Hhd, Hhd, Gs, Hhd, Hhd, Hhd, Gll^Fmf, Gll^Fmf, Gll^Fmf, Gs, Gll^Fmf, Gll^Fmf, Gs, Gs, Gs, Rb^Gvs, Gs, Rb^Gvs, Gs, Gs, Qxu^Bsb|, Gs, Gs, Gs, Gs, Gs, Gs, Gs, Gs, Gs, Rb^Gvs, Rb^Gvs, Hhd, Hhd, Gs, Gs, Gs, Gd, Gs, Gs^Vh, Gs, Gs
Hhd, Gs, Hhd, Hhd, Hhd, Gll^Fmf, Gll^Fmf, Gll^Fmf, Rb^Gvs, Gs^Vh, Gll^Fmf, Gll^Fmf, Gs, Gs, Qxu, Gs, Gs, Gs, Qxu, Qxu, Qxu^Bsb|, Qxu, Qxu, Gs, Gd, Gs, Qxu, Gd, Gs, Rb^Gvs, Rb^Gvs, Rb^Gvs, Gd, Hhd, Gs, Gs, Rb^Gvs, Rb^Gvs, Gs, Gs, Gd, Gs
Gs, Hhd, Gs, Hhd, Hhd, Hhd, Rb^Gvs, Rb^Gvs, Rb^Gvs, Rb^Gvs, Gs, Gs, Hhd, Hhd, Md^Xm, Qxu, Qxu, Qxu, Md^Xm, Qxu, Ch, Qxu, Md^Xm, Qxu, Qxu, Qxu, Md^Xm, Hh, Hh, Gs, Gs, Rb^Gvs, Rb^Gvs, Gd, Gs, Rb^Gvs, Rb^Gvs, Rb^Gvs, Rb^Gvs, Rb^Gvs, Rb^Gvs, Gs
Gd, Gs, Gd, Gs, Gs, Gs^Vh, Rb^Gvs, Rb^Gvs, Rb^Gvs, Rb^Gvs, Gs, Mm, Mm, Mm, Ch, Md^Xm, Md^Xm, Md^Xm, Rr, Ch, Ch, Ch, Rp, Md^Xm, Md^Xm, Md^Xm, Ch, Mm, Mm, Mm, Gs, Gs, Gs, Gs, Gd, Gs^Vh, Gs, Gs, Rb^Gvs, Rb^Gvs, Gd, Gs
Gs, Gs, Gs, Gs, Gs, Gs, Rb^Gvs, Rb^Gvs, Gs, Gs^Vh, Gs, Hhd, Mm, Ch, Rr, Ch, Rp, Rr^Vhc, Rr, Rr, Rp, Rr, Rp, Rr^Vhc, Rr, Ch, Rr, Ch, Mm, Hh, Gs, Gll^Fdf, Gll^Fdf, Gll^Fdf, Gs, Gs, Gs, Gs, Rb^Gvs, Gs, Gs, Gs
Rr, Gd, Gs, Gs, Gs, Gs, Gs, Gs, Gs, Gs^Fms, Gs^Fms, Hhd, Md^Xm, Ch, Ch, Ch, Mm, Rp, Rr^Vhc, Rr, Qxu^Bsb|, Rp, Rr^Vhc, Rr, Mm, Ch, Ch, Ch, Md^Xm, Hh, Gs, Gll^Fdf, Gll^Fdf, Hhd, Gs, Gd, Gll^Fdf, Rb^Gvs, Rb^Gvs, Rb^Gvs, Gs, Gs
Gs, Rr, Rr, Gs^Es, Rr, Gs, Rr, Rr, Rr, Gs, Gs, Qxu, Qxu, Md^Xm, Rr, Rp, Mm, Mm, Qxu, Qxu, Ch, Qxu, Qxu, Mm, Mm, Rr, Rp, Md^Xm, Qxu, Qxu, Gs, Gs, Hhd, Hhd, Hhd, Hhd, Gll^Fdf, Rb^Gvs, Rb^Gvs, Rb^Gvs, Gs, Gs
Gs, Gs, Rb^Gvs, Rr, Rb^Gvs, Rr, Gs, Gs, Gll^Fmf, Rr, Rr, Qxu, Qxu, Md^Xm, Rr, Rr^Vhc, Mm, Qxu, Ch, Ch, Ch, Ch, Ch, Qxu, Mm, Rr^Vhc, Rr, Md^Xm, Qxu, Gs, Gs, Gll^Fdf, Gll^Fdf, Hhd, Gll^Fdf, Hhd, Hhd, Rb^Gvs, Gs, Gs^Vh, Rb^Gvs, Rb^Gvs
Gs, Gs, Rb^Gvs, Rb^Gvs, Gd, Gs^Vh, Gll^Fmf, Gll^Fmf, Gll^Fmf, Gll^Fmf, Gs, Qxu^Bsb\, Qxu^Bsb\, Ch, Rr, Rp, Rp, Qxu^Bsb/, Md^Xm, Md^Xm, 3 Kh, Md^Xm, Md^Xm, Qxu^Bsb\, Rr, Rp, Rp, Ch, Qxu^Bsb\, Qxu, Gs, Gll^Fdf, Gd, Gll^Fdf, Gs^Es, Hhd, Hhd, Gs, Rb^Gvs, Rb^Gvs, Gs, Gs
Hhd, Hhd, Gll^Fmf, Gll^Fmf, Gll^Fmf, Gs, Gs, Hhd, Gll^Fmf, Gll^Fmf, Gll^Fmf, Qxu, Qxu, Ch, Rp, Rp, Mm, Qxu, Ch, Md^Xm, Ch, Md^Xm, Ch, Qxu, Mm, Rr, Rp, Ch, Qxu, Qxu^Bsb\, Rr, Gs, Rr, Gd, Gs, Gs, Gs, Gs, Gs, Gs, Gs, Gs
Hhd, Hhd, Hhd, Gll^Fmf, Hhd, Gs, Gs, Gs, Gll^Fmf, Gll^Fmf, Gll^Fmf, Gs, Qxu, Md^Xm, Rp, Rr^Vhc, Mm, Qxu, Qxu, Ch, Ch, Ch, Qxu, Qxu, Mm, Rr^Vhc, Rr, Md^Xm, Qxu, Qxu, Gs, Rr, Gd, Rr, Gs, Gs, Gs, Gs, Gs, Gs, Gs, Gs
Hhd, Hhd, Hhd, Hhd, Gll^Fmf, Gs, Gs, Gs, Gs^Vh, Gs^Es, Gs, Qxu, Md^Xm, Md^Xm, Ch, Rr, Mm, Mm, Rr^Vhc, Qxu, Qxu^Bsb|, Qxu, Rr^Vhc, Mm, Mm, Rr, Ch, Md^Xm, Md^Xm, Qxu, Gs, Gd, Gll^Fdf, Rr, Rr, Gs, Gs, Gs, Gs, Gs, Gs, Gs
Hhd, Hhd, Gs, Hhd, Gll^Fmf, Gs, Gs, Hhd, Rb^Gvs, Rb^Gvs, Gs, Hhd, Mm, Ch, Rr, Ch, Rp, Rr, Rp, Rr, Rp, Rp, Rp, Rr, Rp, Ch, Rr, Ch, Mm, Hhd, Gs, Gs, Gs, Gs, Rr, Gs, Gs, Gs, Gs, Gs, Gs, Gs
Hhd, Hhd, Gs, Gs^Vh, Rb^Gvs, Gs, Hhd, Rb^Gvs, Rb^Gvs, Rb^Gvs, Gs, Hhd, Mm, Ch, Ch, Ch, Md^Xm, Rr^Vhc, Rr, Rr, Ch, Rr, Rp, Rr^Vhc, Md^Xm, Ch, Ch, Ch, Mm, Hhd, Gs, Gs, Gll^Fmf, Gd, Gs^Es, Rr, Rr, Gs, Gs, Gs, Gs, Gs
Gs, Gs, Rb^Gvs, Rb^Gvs, Rb^Gvs, Hhd, Hhd, Gs^Es, Gs, Rb^Gvs, Gs, Mm, Hhd, Mm, Md^Xm, Md^Xm, Qxu, Md^Xm, Md^Xm, Ch, Ch, Ch, Md^Xm, Md^Xm, Qxu, Md^Xm, Md^Xm, Mm, Hhd, Mm, Gs, Gs, Hhd, Gd, Gd, Gs, Rr, Gs, Gs, Gs, Gs, Gs
Gs, Rb^Gvs, Rb^Gvs, Rb^Gvs, Rb^Gvs, Hhd, Gs, Hhd, Gd, Gs, Gll^Fmf, Gs, Gs, Hhd, Qxu, Qxu, Gs, Qxu, Qxu, Qxu, Qxu^Bsb|, Qxu, Qxu, Qxu, Gs, Qxu, Qxu, Hhd, Gs, Gs, Gll^Fmf, Hhd, Hhd, Gll^Fmf, Gll^Fmf, Gs, Gs, Rr, Rr, Gs, Rr, Gs
Gd, Gs, Gs, Rb^Gvs, Gs, Gs, Gd, Gs, Gd, Hhd, Gll^Fmf, Gs, Hhd, Gs, Gs, Gs, Gll^Fmf, Gs, Gs, Qxu, Qxu^Bsb|, Qxu, Gs, Gs, Hhd, Gs, Gs, Gs, Gs, Gll^Fmf, Gs, Hhd, Hhd, Gll^Fmf, Gll^Fmf, Hh, Gd, Gs, Gs, Rr, Gs, Rr
Gs, Gs, Gs^Es, Gs, Rb^Gvs, Rb^Gvs, Rb^Gvs, Gs, Gs, Gd, Gll^Fmf, Gs, Gll^Fmf, Gs, Gs, Gll^Fmf, Hhd, Hhd, Gs, Gs, Rr, Gd, Gs, Gs, Hhd, Gs, Gll^Fmf, Gll^Fmf, Gll^Fmf, Gll^Fmf, Gs, Hhd, Rb^Gvs, Gll^Fmf, Gll^Fmf, Gll^Fmf, Gs, Gs, Gs, Gs, Gs^Es, Gs
Gs, Gs, Rb^Gvs, Rb^Gvs, Rb^Gvs, Rb^Gvs, Hhd, Hhd, Hhd, Hhd, Gs, Gll^Fmf, Gll^Fmf, Gs, Hhd, Hhd, Hhd, Gs, Hhd, Gs, Rr, Gs, Gs, Hhd, Gs, Hhd, Hhd, Gll^Fmf, Gs, Gll^Fmf, Gs, Gs^Vh, Rb^Gvs, Gs, Gd, Gll^Fmf, Gd, Gs, Gll^Fmf, Gs, Gs, Gs
Gs, Gs, Gd, Rb^Gvs, Gs, Gs, Hhd, Hhd, Hhd, Hhd, Gs, Gs^Vh, Rb^Gvs, Gs, Gs, Gs, Gs, Gs, Gs, Gs, Gs, Rr, Rb^Gvs, Gs, Gs, Gd, Gs, Gs, Gs, Gll^Fmf, Rb^Gvs, Rb^Gvs, Rb^Gvs, Rb^Gvs, Gs, Gs, Ww, Gd, Gs, Gll^Fmf, Gll^Fmf, Gs
Gs, Gs, Gs^Es, Gs, Gs, Hhd, Hhd, Hhd, Hhd, Hhd, Gs, Rb^Gvs, Rb^Gvs, Rb^Gvs, Gll^Fmf, Gs, Gs^Vh, Gs, Gs, Gs, Gs, Rr, Rb^Gvs, Rb^Gvs, Rb^Gvs, Gs^Vh, Gs, Gs, Gs, Gs, Gs, Gs, Gll^Fmf, Gs^Es, Gs, Gs, Ww, Ww, Gs, Gll^Fmf, Gs, Gll^Fmf
Gll^Fmf, Gs, Gs, Gs, Hhd, Hhd, Gs, Gd, Gs^Vh, Gs, Gs, Rb^Gvs, Gll^Fmf, Gs^Gvs, Gll^Fmf, Rb^Gvs, Rb^Gvs, Rb^Gvs, Gs, Gs, Gs, Rr, Rb^Gvs, Rb^Gvs, Gs, Rb^Gvs, Gd, Gd, Gll^Fmf, Gll^Fmf, Gll^Fmf, Gs, Gs, Gll^Fmf, Gll^Fmf, Gll^Fmf, Gs, Gs, Gd, Gs, Gs, Gll^Fmf
Gll^Fmf, Gs, Gll^Fmf, Gs, Gll^Fmf, Gs, Gll^Fmf, Rb^Gvs, Rb^Gvs, Rb^Gvs, Gll^Fmf, Gll^Fmf, Gs, Gll^Fmf, Gs, Rb^Gvs, Rb^Gvs, Rb^Gvs, Gs, Gs, Rr, Rr, Gs, Gs, Gll^Fmf, Gs, Gs, Gs, Gll^Fmf, Gs^Vh, Rb^Gvs, Gd, Gll^Fmf, Gll^Fmf, Gs, Gs, Gs, Gs, Gs, Gd, Gll^Fmf, Gll^Fmf
Gll^Fmf, Gll^Fmf, Gs, Gll^Fmf, Gll^Fmf, Gll^Fmf, Gll^Fmf, Rb^Gvs, Rb^Gvs, Gs, Gs, Gs, Gs, Gll^Fmf, Gs, Gs, Gs, Rb^Gvs, Gs, Rr, Gs, Gs, Gs, Gll^Fmf, Gll^Fmf, Gs, Gs, Gs, Gs, Rb^Gvs, Rb^Gvs, Rb^Gvs, Gs, Gll^Fmf, Gd, Gs, Gs, Gll^Fmf, Gs, Gs, Gs, Gs
Gll^Fmf, Gll^Fmf, Gll^Fmf, Gll^Fmf, Gs, Gll^Fmf, Gs, Gll^Fmf, Gs, Gd, Gll^Fmf, Gs, Gs, Gd, Gll^Fmf, Gll^Fmf, Gs, Gd, Gs^Es, Rr, Gs, Gs, Gs, Gs, Gll^Fmf, Gs, Gll^Fmf, Gs, Gs, Gll^Fmf, Gll^Fmf, Rb^Gvs, Gs, Gs, Gs, Gs, Ce, Gll^Fmf, Gd, Gd, Gs, Gs
Gll^Fmf, Gll^Fmf, Gll^Fmf, Gs, Gd, Gll^Fmf, Gll^Fmf, Gll^Fmf, Gll^Fmf, Gll^Fmf, Gll^Fmf, Gll^Fmf, Gll^Fmf, Gs, Gll^Fmf, Gs, Gs, Gs, Gs, Rr, Rr, Gd, Gs, Gd, Gs, Gll^Fmf, Gll^Fmf, Gs, Gll^Fmf, Gs, Gs, Gs^Es, Gll^Fmf, Gs, Gs, Ce, 5 Ke, Ce, Gs, Gd, Gs, Gs
Gll^Fmf, Gll^Fmf, Gll^Fmf, Gs, Gll^Fmf, Gll^Fmf, Gs, Gs, Gll^Fmf, Gs, Gll^Fmf, Gll^Fmf, Gll^Fmf, Gll^Fmf, Gll^Fmf, Gs, Ce, Ce, Ce, Ce, Rr, Ce, Ce, Ce, Ce, Gs, Gs, Gll^Fmf, Gll^Fmf, Gs, Gs, Gs, Gd, Gs, Gs, Ce, Ce, Ce, Gs, Gs, Gs, Gs
Gs, Gs, Gs, Gll^Fmf, Gs, Gs, Gll^Fmf, Gll^Fmf, Gll^Fmf, Gll^Fmf, Gll^Fmf, Gs, Gll^Fmf, Gll^Fmf, Gll^Fmf, Gs, Ce, 1 Ke, Gs, Gs, Rr, Gs, Gs, 2 Ke, Ce, Gs, Gll^Fmf, Gll^Fmf, Gll^Fmf, Gs, Gll^Fmf, Gs, Gs, Gs, Gs, Gs, Gs, Gs, Gs, Gs, Gs, Gs
Gs, Gll^Fmf, Gs, Gll^Fmf, Gll^Fmf, Gll^Fmf, Gd, Gd, Gll^Fmf, Gll^Fmf, Gll^Fmf, Gll^Fmf, Gll^Fmf, Gll^Fmf, Gll^Fmf, Gd, Gs^Es, Gs, Gs, Re^Vct, Rr, Re^Vct, Gs, Gs, Gll^Fmf, Gll^Fmf, Gll^Fmf, Gll^Fmf, Gll^Fmf, Gll^Fmf, Gll^Fmf, Gll^Fmf, Gs, Gs, Gs, Gs, Gs, Gs, Gs, Gs, Gs, Gd
Gs, Gll^Fmf, Gll^Fmf, Gll^Fmf, Gg, Gll^Fmf, Gd, Gd, Gd, Gd, Gd, Gd, Gd, Gll^Fmf, Gll^Fmf, Gll^Fmf, Gll^Fmf, Gs, Gs, Gd, Rr, Gs, Gd, Gs, Gs, Gll^Fmf, Gg, Gll^Fmf, Gg, Gll^Fmf, Gs, Gs, Gs, Gs, Gs, Gs, Gd, Gs, Gs, Gs, Gs, Gs
