Gd, Gd, Gd, Gg, Gs, Gs, Gs, Gg, Gs^Eff, Gs, Gs^Fms, Gs^Fms, Gg, Gg, Gg, Gg, Gg, Gg, Gg, Gg, Rr, Gs, Gs, Gs, Gs^Fds, Gs^Fms, Gs^Fms, Gs^Fms, Gs^Fms, Gg, Hh, Hh, Hh, Gg, Gs^Fds, Gs^Fds, Gs^Fds, Gg
Re, Gd, Gd, Gs, Gs, Gs, Gs^Eff, Gs^Eff, Re^Gvs, Gs^Eff, Gs^Eff, Gs^Fms, Gs, Gs, Gs^Fms, Gg, Gs^Fms, Gs, Gs^Vh, Gg, Rp, Gs^Fms, Gs^Fds, Gs^Fds, Gg^Efm, Gg, Gs^Fds, Gs^Fms, Hh, Hh, Gd, Hh, Hh, Hh, 4 Ke, Ce, Gs^Fds, Gs^Fds
Re, Re, Re, Gs, Gs, Re^Vh, Re^Gvs, Re^Gvs, Re^Gvs, Re^Gvs, Re^Gvs, Gs^Eff, Gg^Eff, Gs^Fds, Gs^Fms, Gs^Fms, Gd, Gg, Gs, Gs, Rp, Gs^Fms, Gs^Fds, Gs^Fds, Hh^Fds, Hh^Fds, Gs^Fds, Gs, Gs, Gd, Gg, Hh, Hh, Ce, Ce, Ce, Ce, Gs^Fds
Gg, Gg, Gs^Fms, Rp, Rp, Re^Gvs, Re^Gvs, Re^Gvs, Re^Gvs, Re^Gvs, Re^Gvs, Re^Gvs, Gs^Eff, Gg^Eff, Gs^Fms, Gd, Gs, Gs^Fds, Re, Rp, Gd^Es, Gd, Gd, Hh, Gd, Hh, Gs^Fds, Gg^Fds, Gs, Gs^Vh, Gg, Gg, Hh, Ce, Gd, Gd, Hh^Fds, Gs^Fds
Gs^Fds, Gg^Efm, Gs^Fms, Gs^Fms, Rp, Re^Gvs, Re^Gvs, Re^Gvs, Re^Gvs, Re^Gvs, Gg^Eff, Gg^Eff, Gg^Es, Gs^Fms, Gd, Gs^Fms, Gd^Es, Gd, Rr, Rp^Es, Gd, Gs, Gs^Vh, Gd, Gs^Fds, Gs, Gg, Gg, Gs^Fds, Gs, Hh, Gd, Gd, Gs, Gs, Hh, Hh, Gs^Fds
Gs^Fds, Gs^Fms, Gg^Efm, Gs^Fms, Rp, Gd, Gd, Re^Gvs, Gs^Fms, Gs^Eff, Gs^Fds, Gs^Fms, Re, Gg, Re, Re^Es, Re, Gd, Rr, Rp, Re^Es, Gs, Gs, Gs, Gs, Gs, Gs, Gs^Efm, Gg, Hh^Fds, Hh, Gs^Fds, Gs^Fds, Gs, Hh, Hh, Hh^Fds, Gs^Fds
Gs^Fds, Gs^Fds, Re^Vh, Gs, Gs, Rp, Re, Gg, Gg^Es, Gs, Re, Re, Qxu, Re^Es, Re, Re^Es, Re, Rr, Rr, Rr, Rr, Rr, Rr, Rr, Qxu, Gs, Gg, Gg, Gg, Hh, Hh, Hh^Fds, Gs^Fds, Gs^Fds, Gg, Hh, Gd, Gg
Gs^Fms, Re^Gvs, Re^Gvs, Re^Gvs, Re^Gvs, Gs, Gs, Re, Re, Re, Hh, Qxu, Md^Xm, Qxu, Qxu, Qxu, Md^Xm, Rr, Ch, Rr, Md^Xm, Qxu, Qxu, Qxu, Md^Xm, Qxu, Hh, Gg, Gg, Hh^Fds, Gd^Eff, Gd^Eff, Gd^Eff, Gd, Gs, Gd, Gg, Gg
Gs^Fms, Gs^Fms, Re^Gvs, Re^Gvs, Re^Gvs, Re^Gvs, Re^Gvs, Re^Es, Re, Hh, Mm, Mm, Ch, Md^Xm, Md^Xm, Md^Xm, Isa, Ch, Ch, Ch, Isa, Md^Xm, Md^Xm, Md^Xm, Ch, Mm, Mm, Hh, Gg, Gs^Fds, Gs, Re^Vh, Re^Gvs, Gd^Eff, Gd^Eff, Gg, Gg, Gg
Gs^Fms, Gs^Fms, Re^Gvs, Re^Gvs, Re^Gvs, Re^Gvs, Re^Gvs, Re, Re, Hh, Mm, Ch, Isa, Ch, Isa, Isa^Vhc, Isa, Isa, Isa, Isa, Isa, Isa^Vhc, Isa, Ch, Isa, Ch, Mm, Hh, Re, Gs, Re^Gvs, Re^Gvs, Re^Gvs, Re^Gvs, Re^Gvs, Gs^Eff, Gs^Eff, Gg
Gs^Fms, Gs^Fms, Gs^Fms, Re^Gvs, Re^Vh, Re^Gvs, Re, Re, Re^Es, Qxu, Mm^Xm, Ch, Ch, Ch, Mm, Isa, Isa^Vhc, Isa, Isa, Isa, Isa^Vhc, Isa, Mm, Ch, Ch, Ch, Md^Xm, Qxu, Re, Gs^Es, Gs, Re^Gvs, Re^Gvs, Re^Gvs, Gs^Eff, Gs^Eff, Gs, Gs
Gs^Fms, Gs^Fms, Gs^Fms, Gs, Gs, Gs, Gd^Es, Gd, Re, Qxu, Qxu, Md^Xm, Isa, Isa, Mm, Mm, Qxu, Qxu, Ch, Qxu, Qxu, Mm, Mm, Isa, Isa, Md^Xm, Qxu, Qxu, Re, Re^Es, Re^Es, Re, Gs^Fms, Gs^Fms, Gs^Fms, Gs^Vh, Gd, Gs
Re, Gs^Fms, Gs, Gs^Fms, Re, Gs^Fms, Gd, Gd, Rp^Es, Rp, Rr, Md^Xm, Isa, Isa^Vhc, Mm, Qxu, Ch, Ch, Ch, Ch, Ch, Qxu, Mm, Isa^Vhc, Isa, Md^Xm, Rr, Re, Re, Gd, Gs, Gs^Fms, Gg^Efm, Gs^Fms, Gs^Fds, Gs, Gs^Fms, Gs^Fds
Gg, Re, Re, Re, Re, Re, Re, Rp, Rr, Rp^Es, Rr, Ch, Isa, Isa, Isa, Isa, Mm^Xm, Mm^Xm, 3 Kh, Mm^Xm, Mm^Xm, Isa, Isa, Isa, Isa, Ch, Rr, Rr, Rp, Gd, Gs^Fms, Gs^Fds, Gg, Gg, Gs, Gs^Fms, Gs^Fds, Gs
Gs, Gs, Gs, Gs, Gd^Efm, Gd, Gs, Gs, Gs^Es, Rp^Es, Rr, Ch, Isa, Isa, Mm, Isa, Ch, Mm^Xm, Ch, Mm^Xm, Ch, Isa, Mm, Isa, Isa, Ch, Rr, Rp, Gs, Rp, Rp, Gs^Fds, Re^Vh, Gd, Gd, Gd, Rr, Rr
Gs, Gs, Gs^Fms, Gs^Fms, Gg, Gg, Gs^Vh, Gs, Rr, Rr, Qxu, Md^Xm, Isa, Isa^Vhc, Mm, Qxu, Qxu, Ch, Ch, Ch, Qxu, Qxu, Mm, Isa^Vhc, Isa, Md^Xm, Qxu, Rr, Rr, Gs^Es, Gg, Rp, Rr, Rr, Rr, Rr, Gg, Gg
Gs, Gs, Gd, Gg, Gg, Gs, Gs, Gs^Es, Gs^Es, Qxu, Mm^Xm, Md^Xm, Ch, Isa, Mm, Mm, Isa^Vhc, Qxu, Isa, Qxu, Isa, Mm, Mm, Isa, Ch, Md^Xm, Md^Xm, Qxu, Rr, Gs, Hh, Gs, Gd, Gg, Gg, Gg^Es, Gd, Gg
Gg, Gd, Gg^Efm, Gg^Es, Gs^Fms, Gd, Gs, Gs, Gs, Qxu, Mm, Ch, Isa, Ch, Isa, Isa, Isa, Isa, Isa, Isa, Isa, Isa, Isa, Ch, Isa, Ch, Mm, Qxu, Re, Gs, Gg, Gs, Hh, Gs^Fds, Gs, Gg, Gd, Gd
Gg, Gd, Gg, Gg, Gd, Gd, Gs^Es, Gs^Es, Gg, Hh, Mm, Ch, Ch, Ch, Md^Xm, Isa^Vhc, Isa, Isa, Ch, Isa, Isa, Isa^Vhc, Md^Xm, Ch, Ch, Ch, Mm, Hh, Re, Gs, Gg, Hh, Gs^Fds, Hh^Fds, Hh, Gs^Vh, Gs, Gd
Gs, Gg, Gg, Gs^Vh, Gs, Gd, Gd, Gs^Fms, Gs, Hh, Hh, Mm, Md^Xm, Md^Xm, Qxu, Md^Xm, Md^Xm, Ch, Ch, Ch, Md^Xm, Md^Xm, Qxu, Md^Xm, Mm^Xm, Mm, Hh, Hh, Re^Es, Gg^Es, Gs, Gd, Gd^Es, Gg, Hh, Gg, Gs^Efm, Gg
Gs, Gs, Gg^Efm, Gs, Gs, Gg^Efm, Gs, Gs^Es, Gs, Gs, Gg, Qxu, Qxu, Qxu, Gs^Fds, Qxu, Rr, Rr, Rr, Rr, Rp, Qxu, Re, Qxu, Qxu, Qxu, Re, Re, Re, Re^Es, Gs, Gd, Gd, Gd, Gd, Gs, Gg, Gg
Gg, Gs, Gll^Fp, Gg, Gll^Fp, Gs, Gg^Efm, Gg, Gs, Gs, Gs^Eff, Gg, Gs^Fms, Gs^Es, Gs^Fds, Rr, Gs^Fds, Rr^Es, Rp, Rp, Re^Es, Re, Gd, Gs, Gs, Gs, Gs, Gs^Es, Re, Re, Re, Re^Vh, Re^Gvs, Re^Gvs, Re^Gvs, Gg, Gg, Gg
Gll^Fp, Gll^Fp, Gll^Fmw, Gll^Fp, Gs, Gs, Gs, Gs, Gs^Eff, Gs^Eff, Re^Gvs, Gs^Eff, Gs^Eff, Gs, Gg, Gs^Fms, Gg, Gs, Rp, Gd, Re^Es, Gd, Gs, Gs^Es, Re^Gvs, Re^Gvs, Re^Gvs, Re, Gs^Fms, Gs^Fms, Gs^Fds, Re^Gvs, Re^Gvs, Re^Gvs, Re^Gvs, Re^Gvs, Gs, Gg
Gll^Fp, Gll^Fmw, Gll^Fp, Gll^Fp, Gs, Gs, Re^Eff, Gs^Eff, Re^Gvs, Re^Gvs, Re^Gvs, Re^Wm, Re^Gvs, Gs^Eff, Gs^Eff, Gs^Fms, Gs, Gs, Rp, Gd, Gs, Gs, Gg, Re^Gvs, Re^Gvs, Re^Gvs, Re^Gvs, Gd^Wm, Re^Gvs, Gs^Fds, Gs^Fms, Re^Gvs, Re^Gvs, Re^Gvs, Gg, Gg^Efm, Gs, Gg
Gg, Gll^Fp, Gll^Fmw, Gll^Fp, Gs, Re^Vh, Gs, Re^Eff, Re, Re^Gvs, Re^Gvs, Re^Gvs, Re^Gvs, Re^Gvs, Gs^Eff, Gs^Eff, Gg^Efm, Gs, Gs, Rr, Gs^Fms, Gs^Fds, Gs, Re^Vh, Re^Gvs, Re^Gvs, Re^Gvs, Re^Gvs, Re^Gvs, Gd, Gg, Gs, Gs^Fms, Gs, Gg, Gs, Gd, Gg
Gll^Fp, Gll^Fp, Ce, Gll^Fp, Ce, Gs, Gll^Fp, Gs, Gs, Gs^Eff, Gs^Eff, Re^Gvs, Gs^Eff, Gs^Eff, Gs, Gg, Gs, Gs, Gg, Rr, Gs, Gs^Fms, Re, Re, Re^Vh, Re^Gvs, Re^Gvs, Re^Gvs, Re^Gvs, Gd, Gd, Gs^Efm, Gs, Gg, Gs^Fds, Gs, Gs^Fds, Gg
Gll^Fp, Re, Ce, 1 Ke, Re, Re, Gll^Fp, Gg, Gs, Gs^Vh, Gll^Fp, Gs, Gll^Fp, Gs, Gs, Gs, Gll^Fp, Gg, Gg, Rr, Rr, Re, Gs^Fms, Gs^Fds, Gs, Re^Gvs, Re^Gvs, Re^Gvs, Re^Gvs, Re^Gvs, Gs, Gs, Gg, Gg, Gs^Fms, Gs^Fds, Gs^Fds, Gg
Gll^Fmw, Re, Re, 2 Ce, Ce, Re, Re, Gs^Fms, Gll^Fp, Gs^Fms, Gll^Fp, Gll^Fp, Gs^Fms, Gll^Fp, Gs, Gg, Gs^Fms, Gg^Es, Gg, Gg, Gg, Rr, Gd, Gs^Fms, Gs^Fds, Gs, Gs, Re^Gvs, Re^Gvs, Re^Gvs, Re^Vh, Gs, Gg, Gs^Fds, Gg, Gg, Gs^Fms, Gs^Fds
Gll^Fmw, Gll^Fp, Re, Ce, Gll^Fp, Ce, Gll^Fp, Gs^Fms, Gll^Fp, Gll^Fp, Gll^Fp, Gs^Fms, Gs^Fms, Gll^Fp, Gg^Em, Gs^Fms, Gs^Fms, Gs, Re^Vh, Gg, Gg, Rr, Gs, Gs^Fds, Gg, Gs, Gs, Re^Gvs, Re^Gvs, Re^Gvs, Gg, Gg, Gg^Efm, Gg, Gs, Gs, Gs^Fms, Gs^Fds
Gll^Fp, Gll^Fp, Gll^Fp, Gll^Fp, Gll^Fmw, Gll^Fp, Gll^Fp, Gll^Fp, Gg^Em, Gg^Em, Gs^Fms, Gs^Fms, Gs^Fms, Gll^Fp, Gll^Fp, Gs^Fms, Gs^Fms, Gs, Gll^Fp, Re, Re, Rr, Gg, Gs^Fms, Gg, Gs, Gs, Gs, Gs, Gg, Gs^Fds, Gg, Gs^Fms, Gg, Gs^Fms, Gs^Fms, Gg, Gg
Gg, Gll^Fp, Gll^Fp, Gll^Fp, Gll^Fp, Gll^Fp, Gll^Fp, Gg, Gg, Gg, Gs, Gll^Fp, Gg, Gll^Fp, Gll^Fp, Gll^Fp, Gs^Fms, Gll^Fp, Gll^Fp, Gg, Gg, Rr, Gg, Gg, Gg, Gg, Gg, Gg, Gs, Gs^Fds, Gs^Fds, Gs^Fds, Gs^Fds, Gs^Fms, 5 Gs^Fds, Gs^Fds, Gs^Fms, Gs^Fds
